Word	Lemma	PoS	Corrected lemma
কালে	কাল	বিশেষ্য	
কালের	কাল	বিশেষ্য	
কালই	কাল	বিশেষ্য	
কালটা	কাল	বিশেষ্য	
কালটাতে	কাল	বিশেষ্য	
কলার	কলা	বিশেষ্য	
কলাতে	কলা	বিশেষ্য	
কলাটি	কলা	বিশেষ্য	
কলাটির	কলা	বিশেষ্য	
কলাই	কলা	বিশেষ্য	
কেরসিনে	কেরসিন	বিশেষ্য	
কেরসিনের	কেরসিন	বিশেষ্য	
কেরসিনটা	কেরসিন	বিশেষ্য	
কেরসিনই	কেরসিন	বিশেষ্য	
কদবেলে	কদবেল	বিশেষ্য	
কদবেলটা	কদবেল	বিশেষ্য	
কদবেলটি	কদবেল	বিশেষ্য	
কদবেলই	কদবেল	বিশেষ্য	
কার্যে	কার্য	বিশেষ্য	
কার্যের	কার্য	বিশেষ্য	
কার্যটা	কার্য	বিশেষ্য	
কার্যটি	কার্য	বিশেষ্য	
কালোর	কালো	বিশেষ্য	
কালোই	কালো	বিশেষ্য	
কালোদের	কালো	বিশেষ্য	
কালোটা	কালো	বিশেষ্য	
করবে	করা	ক্রিয়া	
করিয়াছে	করা	ক্রিয়া	
কর	করা	ক্রিয়া	
করেছে	করা	ক্রিয়া	
করছেন	করা	ক্রিয়া	
করেন	করা	ক্রিয়া	
কুলার	কুলা	বিশেষ্য	
কুলাটি	কুলা	বিশেষ্য	
কুলাটা	কুলা	বিশেষ্য	
কুলাতে	কুলা	বিশেষ্য	
বকুলের	বকুল	বিশেষ্য	
বকুলকে	বকুল	বিশেষ্য	
বকুলদের	বকুল	বিশেষ্য	
বকুলই	বকুল	বিশেষ্য	
বকুলটা	বকুল	বিশেষ্য	
কুসুমের	কুসুম	বিশেষ্য	
কুসুমকে	কুসুম	বিশেষ্য	
কুসুমই	কুসুম	বিশেষ্য	
কুসুমরে	কুসুম	বিশেষ্য	
কুসুমদের	কুসুম	বিশেষ্য	
কুমারের	কুমার	বিশেষ্য	
কুমারদের	কুমার	বিশেষণ	
কুমারই	কুমার	বিশেষ্য	
কুমারকে	কুমার	বিশেষ্য	
কৃষকের	কৃষক	বিশেষ্য	
কৃষকদের	কৃষক	বিশেষ্য	
কৃষকে	কৃষক	বিশেষ্য	
কৃষকরা	কৃষক	বিশেষ্য	
কৃষকই	কৃষক	বিশেষ্য	
কুকুরে	কুকুর	বিশেষ্য	
কুকুরকে	কুকুর	বিশেষ্য	
কুকুরদের	কুকুর	বিশেষ্য	
কুকুরটি	কুকুর	বিশেষ্য	
কুকুরটা	কুকুর	বিশেষ্য	
কুকুরের	কুকুর	বিশেষ্য	
কাজে	কাজ	বিশেষ্য	
কাজকেই	কাজ	বিশেষ্য	
কাজেই	কাজ	বিশেষ্য	
কাজের	কাজ	বিশেষ্য	
কাজই	কাজ	বিশেষ্য	
কথাই	কথা	বিশেষ্য	
কথায়	কথা	বিশেষ্য	
কথার	কথা	বিশেষ্য	
কথাকে	কথা	বিশেষ্য	
কথাতেই	কথা	বিশেষ্য	
কথাতে	কথা	বিশেষ্য	
কলহের	কলহ	বিশেষ্য	
কলহকে	কলহ	বিশেষ্য	
কলহতে	কলহ	বিশেষ্য	
কলহই	কলহ	বিশেষ্য	
কলহে	কলহ	বিশেষ্য	
কেবলই	কেবল	বিশেষ্য	
কমিটির	কমিট	বিশেষ্য	কমিটি
কমিটিকে	কমিট	বিশেষ্য	কমিটি
কমিটিদের	কমিট	বিশেষ্য	কমিটি
কমিটিতে	কমিট	বিশেষ্য	কমিটি
কমিটিরা	কমিট	বিশেষ্য	কমিটি
কমিশনকে	কমিশন	বিশেষ্য	
কমিশনের	কমিশন	বিশেষ্য	
কমিশনটা	কমিশন	বিশেষ্য	
কমিশনই	কমিশন	বিশেষ্য	
কমিশনে	কমিশন	বিশেষ্য	
কমলাটা	কমলা	বিশেষ্য	
কমলাটি	কমলা	বিশেষ্য	
কমলাটির	কমলা	বিশেষ্য	
কমলাতে	কমলা	বিশেষ্য	
কমলাই	কমলা	বিশেষ্য	
কমলাকে	কমলা	বিশেষ্য	
কমলাটার	কমলা	বিশেষ্য	
কমলার	কমলা	বিশেষ্য	
কোম্পানিতে	কোম্পানি	বিশেষ্য	
কোম্পানিকে	কোম্পানি	বিশেষ্য	
কোম্পানিটি	কোম্পানি	বিশেষ্য	
কোম্পানির	কোম্পানি	বিশেষ্য	
কোম্পানিটা	কোম্পানি	বিশেষ্য	
কোমলতার	কোমল	বিশেষ্য	
কোমলে	কোমল	বিশেষ্য	
কোমলকে	কোমল	বিশেষ্য	
কোমলই	কোমল	বিশেষ্য	
কবির	কবি	বিশেষ্য	
কবিকে	কবি	বিশেষ্য	
কবিদের	কবি	বিশেষ্য	
কতো	কত	বিশেষ্য	কতো
কতটা	কত	বিশেষণ	
কতটি	কত	বিশেষণ	
কতরে	কত	বিশেষণ	
কতই	কত	বিশেষণ	
কতোটা	কত	বিশেষণ	কতো
কতোটি	কত	বিশেষণ	কতো
কমে	কম	বিশেষণ	
কমেছে	কম	ক্রিয়া	কমা
কমছে	কম	ক্রিয়া	কমা
কমছিল	কম	ক্রিয়া	কমা
কমছেন	কম	ক্রিয়া	কমা
কমতেছি	কম	ক্রিয়া	কমা
কমিতেছি	কম	ক্রিয়া	কমা
কমছি	কম	ক্রিয়া	কমা
কমেছি	কম	ক্রিয়া	কমা
ক্ষতেরই	ক্ষত	বিশেষ্য	
কুন্ডলীর	কুন্ডলী	বিশেষ্য	
কুন্ডলীতে	কুন্ডলী	বিশেষ্য	
কুন্ডলীকে	কুন্ডলী	বিশেষ্য	
কুন্ডলীতেই	কুন্ডলী	বিশেষ্য	
কুন্ডলীই	কুন্ডলী	বিশেষ্য	
কিতাবে	কিতাব	বিশেষ্য	
কিতাবটা	কিতাব	বিশেষ্য	
কিতাবটি	কিতাব	বিশেষ্য	
কিতাবের	কিতাব	বিশেষ্য	
কিতাবকে	কিতাব	বিশেষ্য	
কাকার	কাকা	বিশেষ্য	
কাকাকে	কাকা	বিশেষ্য	
কাকাই	কাকা	বিশেষ্য	
কাকির	কাকি	বিশেষ্য	
কাকিকে	কাকি	বিশেষ্য	
কাকিদের	কাকি	বিশেষ্য	
কাকিরা	কাকি	বিশেষ্য	
কাকিই	কাকি	বিশেষ্য	
কুড়িতে	কুড়ি	বিশেষ্য	
কুড়ির	কুড়ি	বিশেষ্য	
কামরকে	কামার	বিশেষ্য	
কামারেরা	কামার	বিশেষ্য	
কামারদের	কামার	বিশেষ্য	
কামারই	কামার	বিশেষ্য	
কামারটা	কামার	বিশেষ্য	
কুমড়াতে	কুমড়া	বিশেষ্য	
কুমড়ার	কুমড়া	বিশেষ্য	
কুমরাটি	কুমড়া	বিশেষ্য	
কুমড়াটা	কুমড়া	বিশেষ্য	
কুমড়াই	কুমড়া	বিশেষ্য	
কলেজটি	কলেজ	বিশেষ্য	
কলেজর	কলেজ	বিশেষ্য	
কলেজটা	কলেজ	বিশেষ্য	
কলেজকে	কলেজ	বিশেষ্য	
কলমির	কলমি	বিশেষ্য	
কলমিতে	কলমি	বিশেষ্য	
কলমটি	কলম	বিশেষ্য	
কলমটিতে	কলম	বিশেষ্য	
কলমটির	কলম	বিশেষ্য	
কলমকে	কলম	বিশেষ্য	
কলমে	কলম	বিশেষ্য	
কলমের	কলম	বিশেষ্য	
কলমেই	কলম	বিশেষ্য	
কলমই	কলম	বিশেষ্য	
কবুলের	কবুল	বিশেষ্য	
কানে	কান	বিশেষ্য	
কানের	কান	বিশেষ্য	
কানটি	কান	বিশেষ্য	
কনাটা	কান	বিশেষ্য	
কানই	কান	বিশেষ্য	
কাঁঠালে	কাঁঠাল	বিশেষ্য	
কাঁঠালের	কাঁঠাল	বিশেষ্য	
কাঠালই	কাঁঠাল	বিশেষ্য	
কাঠালটি	কাঁঠাল	বিশেষ্য	
কাঁঠালটাকে	কাঁঠাল	বিশেষ্য	
কাঁঠালিটকে	কাঁঠাল	বিশেষ্য	
কাচে	কাচ	বিশেষ্য	
কাচের	কাচ	বিশেষ্য	
কাচটি	কাচ	বিশেষ্য	
কাচটা	কাচ	বিশেষ্য	
কাচই	কাচ	বিশেষ্য	
কাঁদার	কাঁদা	বিশেষ্য	
কাঁদাতে	কাঁদা	বিশেষ্য	
কাঁদাই	কাঁদা	বিশেষ্য	
কাঁদায়	কাঁদা	বিশেষ্য	
কাঁদাকে	কাঁদা	বিশেষ্য	
কামরাটি	কামরা	বিশেষ্য	
কামরাটা	কামরা	বিশেষ্য	
কামরাতে	কামরা	বিশেষ্য	
কামরায়	কামরা	বিশেষ্য	
কামরার	কামরা	বিশেষ্য	
কখনো	কখন	বিশেষ্য	
কখনই	কখন	বিশেষ্য	
কখনোই	কখন	বিশেষ্য	
কচুতে	কচু	বিশেষ্য	
কচুটি	কচু	বিশেষ্য	
কচুটা	কচু	বিশেষ্য	
কচুর	কচু	বিশেষ্য	
কচুই	কচু	বিশেষ্য	
কচুটাতে	কচু	বিশেষ্য	
কচুকে	কচু	বিশেষ্য	
কাছিমে	কাছিম	বিশেষ্য	
কাছিমটি	কাছিম	বিশেষ্য	
কাছিমটা	কাছিম	বিশেষ্য	
কাছিমকে	কাছিম	বিশেষ্য	
কাছিমের	কাছিম	বিশেষ্য	
কড়াইতে	কড়াই	বিশেষ্য	
কড়াইটা	কড়াই	বিশেষ্য	
কড়াইটি	কড়াই	বিশেষ্য	
কড়াইকে	কড়াই	বিশেষ্য	
কদমই	কদম	বিশেষ্য	
কদমে	কদম	বিশেষ্য	
কদমের	কদম	বিশেষ্য	
কদমটি	কদম	বিশেষ্য	
কদমটা	কদম	বিশেষ্য	
কদমটির	কদম	বিশেষ্য	
কাটার	কাটা	বিশেষ্য	
কাটাতে	কাটা	বিশেষ্য	
কটাটা	কাটা	বিশেষ্য	কটা
কাটাই	কাটা	বিশেষ্য	
কনের	কনে	বিশেষ্য	
কনেকে	কনে	বিশেষ্য	
কনেদের	কনে	বিশেষ্য	
কুমারীকে	কুমারী	বিশেষ্য	
কুমারীদের	কুমারী	বিশেষ্য	
কুমারীরা	কুমারী	বিশেষ্য	
কুমারীই	কুমারী	বিশেষ্য	
কপালে	কপাল	বিশেষ্য	
কপালকে	কপাল	বিশেষ্য	
কপালটা	কপাল	বিশেষ্য	
কপালটায়	কপাল	বিশেষ্য	
কপালের	কপাল	বিশেষ্য	
কফে	কফ	বিশেষ্য	
কফের	কফ	বিশেষ্য	
কফই	কফ	বিশেষ্য	
কফটায়	কফ	বিশেষ্য	
কফকে	কফ	বিশেষ্য	
কফিনে	কফিন	বিশেষ্য	
কফিনটি	কফিন	বিশেষ্য	
কফিনটা	কফিন	বিশেষ্য	
কফিনই	কফিন	বিশেষ্য	
কফিনের	কফিন	বিশেষ্য	
কাশিটা	কাশি	বিশেষ্য	
কাশির	কাশি	বিশেষ্য	
কাশিতে	কাশি	বিশেষ্য	
কাশিটার	কাশি	বিশেষ্য	
কবুতরে	কবুতর	বিশেষ্য	
কবুতরের	কবুতর	বিশেষ্য	
কবুতরটি	কবুতর	বিশেষ্য	
কবুতরটা	কবুতর	বিশেষ্য	
কবুতরকে	কবুতর	বিশেষ্য	
কবিতাটা	কবিতা	বিশেষ্য	
কবিতাটি	কবিতা	বিশেষ্য	
কবিতাকে	কবিতা	বিশেষ্য	
কবিতাই	কবিতা	বিশেষ্য	
কবিতার	কবিতা	বিশেষ্য	
কবিরাজকে	কবিরাজ	বিশেষ্য	
কবিরাজের	কবিরাজ	বিশেষ্য	
কবিরাজরা	কবিরাজ	বিশেষ্য	
কবিরাজদের	কবিরাজ	বিশেষ্য	
কবিরাজই	কবিরাজ	বিশেষ্য	
কলসে	কলস	বিশেষ্য	
কলসটা	কলস	বিশেষ্য	
কলসের	কলস	বিশেষ্য	
কলসটি	কলস	বিশেষ্য	
কলসটার	কলস	বিশেষ্য	
কয়েদীর	কয়েদী	বিশেষ্য	
কয়েদীকে	কয়েদী	বিশেষ্য	
কয়েদীরে	কয়েদী	বিশেষ্য	
কয়েদীই	কয়েদী	বিশেষ্য	
কলেরায়	কলেরা	বিশেষ্য	
কলেরাতে	কলেরা	বিশেষ্য	
কলেরার	কলেরা	বিশেষ্য	
কলেরাকে	কলেরা	বিশেষ্য	
কলেরাই	কলেরা	বিশেষ্য	
কোদালটায়	কোদাল	বিশেষ্য	
কোদালকে	কোদাল	বিশেষ্য	
কোদালে	কোদাল	বিশেষ্য	
কোদালটা	কোদাল	বিশেষ্য	
কোদালটি	কোদাল	বিশেষ্য	
কেঁচোকে	কেঁচো	বিশেষ্য	
কেঁচোটা	কেঁচো	বিশেষ্য	
কেঁচোটি	কেঁচো	বিশেষ্য	
কেঁচোতে	কেঁচো	বিশেষ্য	
কেঁচোর	কেঁচো	বিশেষ্য	
কোকিলকে	কোকিল	বিশেষ্য	
কোকিললের	কোকিল	বিশেষ্য	
কোকিলটা	কোকিল	বিশেষ্য	
কোকিলটি	কোকিল	বিশেষ্য	
কোকিলদের	কোকিল	বিশেষ্য	
কোণকে	কোণ	বিশেষ্য	
কোণটি	কোণ	বিশেষ্য	
কোণটা	কোণ	বিশেষ্য	
কোণই	কোণ	বিশেষ্য	
কেবিনে	কেবিন	বিশেষ্য	
কেবিনকে	কেবিন	বিশেষ্য	
কেবিনটি	কেবিন	বিশেষ্য	
কেবিনটা	কেবিন	বিশেষ্য	
কেবিনের	কেবিন	বিশেষ্য	
কাঁকড়ার	কাঁকড়া	বিশেষ্য	
কাঁকড়াতে	কাঁকড়া	বিশেষ্য	
কাঁকড়াটা	কাঁকড়া	বিশেষ্য	
কাঁকড়াটি	কাঁকড়া	বিশেষ্য	
কাঁকড়াকে	কাঁকড়া	বিশেষ্য	
কাঁকড়ায়	কাঁকড়া	বিশেষ্য	
কচ্ছপটা	কচ্ছপ	বিশেষ্য	
কচ্ছপটি	কচ্ছপ	বিশেষ্য	
কচ্ছপের	কচ্ছপ	বিশেষ্য	
কচ্ছপকে	কচ্ছপ	বিশেষ্য	
কচ্ছপদের	কচ্ছপ	বিশেষ্য	
কুমিরের	কুমির	বিশেষ্য	
কুমিরটা	কুমির	বিশেষ্য	
কুমিরটি	কুমির	বিশেষ্য	
কুমিরকে	কুমির	বিশেষ্য	
কুমিরদের	কুমির	বিশেষ্য	
কুমিরটাকে	কুমির	বিশেষ্য	
খানাতে	খানা	বিশেষ্য	
খানাটা	খানা	বিশেষ্য	
খাঁচাতে	খাঁচা	বিশেষ্য	
খাঁচাটা	খাঁচা	বিশেষ্য	
খাঁচাটি	খাঁচা	বিশেষ্য	
খাঁচার	খাঁচা	বিশেষ্য	
খাঁচাকে	খাঁচা	বিশেষ্য	
খেলনাটি	খেলনা	বিশেষ্য	
খেলনাতে	খেলনা	বিশেষ্য	
খেলনাটা	খেলনা	বিশেষ্য	
খেলনার	খেলনা	বিশেষ্য	
খেলনাকে	খেলনা	বিশেষ্য	
খালার	খালা	বিশেষ্য	
খালাকে	খালা	বিশেষ্য	
খালাই	খালা	বিশেষ্য	
খালাদের	খালা	বিশেষ্য	
খালারা	খালা	বিশেষ্য	
খেয়ালটা	খেয়াল	বিশেষ্য	
খেয়ালই	খেয়াল	বিশেষ্য	
খাঁড়ে	খাঁড়	বিশেষ্য	
খাঁড়ের	খাঁড়	বিশেষ্য	
খাঁড়টা	খাঁড়	বিশেষ্য	
খাঁড়ই	খাঁড়	বিশেষ্য	
খাঁড়ক	খাঁড়	বিশেষ্য	
খোলার	খোলা	বিশেষ্য	
খোলাই	খোলা	বিশেষ্য	
খোপাতে	খোপা	বিশেষ্য	
খোপার	খোপা	বিশেষ্য	
খোপাটি	খোপা	বিশেষ্য	
খোপাটা	খোপা	বিশেষ্য	
খোলসটা	খোলস	বিশেষ্য	
খোলসটি	খোলস	বিশেষ্য	
খোলসে	খোলস	বিশেষ্য	
খোলসের	খোলস	বিশেষ্য	
খোলসই	খোলস	বিশেষ্য	
খোরাকে	খোরাক	বিশেষ্য	
খোরাকের	খোরাক	বিশেষ্য	
খেচরটা	খেচর	বিশেষ্য	
খেচরটি	খেচর	বিশেষ্য	
খেচরকে	খেচর	বিশেষ্য	
খেচররা	খেচর	বিশেষ্য	
খেচরদের	খেচর	বিশেষ্য	
খুরটা	খুর	বিশেষ্য	
খুরটি	খুর	বিশেষ্য	
খুরে	খুর	বিশেষ্য	
খুরের	খুর	বিশেষ্য	
খুরই	খুর	বিশেষ্য	
খোপে	খোপ	বিশেষ্য	
খোপের	খোপ	বিশেষ্য	
খোপটি	খোপ	বিশেষ্য	
খোপটা	খোপ	বিশেষ্য	
খোপটার	খোপ	বিশেষ্য	
খোপটিতে	খোপ	বিশেষ্য	
খিলাফে	খিলাফ	বিশেষ্য	
খিলাফটা	খিলাফ	বিশেষ্য	
খিলাফটি	খিলাফ	বিশেষ্য	
খিলাফের	খিলাফ	বিশেষ্য	
খিলাফকে	খিলাফ	বিশেষ্য	
খিলালে	খিলাল	বিশেষ্য	
খিলালের	খিলাল	বিশেষ্য	
খিলালটা	খিলাল	বিশেষ্য	
খিলালটি	খিলাল	বিশেষ্য	
খিলালই	খিলাল	বিশেষ্য	
খিলালটার	খিলাল	বিশেষ্য	
খিলানে	খিলান	বিশেষ্য	
খিলানই	খিলান	বিশেষ্য	
খিলানটি	খিলান	বিশেষ্য	
খিলানটা	খিলান	বিশেষ্য	
খিলানের	খিলান	বিশেষ্য	
খিলানটায়	খিলান	বিশেষ্য	
খলিফার	খলিফা	বিশেষ্য	
খলিফাকে	খলিফা	বিশেষ্য	
খলিফাদের	খলিফা	বিশেষ্য	
খলিফারা	খলিফা	বিশেষ্য	
খিদার	খিদা	বিশেষ্য	
খিদাই	খিদা	বিশেষ্য	
খরার	খরা	বিশেষ্য	
খরাতে	খরা	বিশেষ্য	
খরচে	খরচ	বিশেষ্য	
খরচই	খরচ	বিশেষ্য	
খরচটা	খরচ	বিশেষ্য	
খায়েশে	খায়েশ	বিশেষ্য	
খায়েশটা	খায়েশ	বিশেষ্য	
খায়েশই	খায়েশ	বিশেষ্য	
খামচির	খামচি	বিশেষ্য	
খামচিটা	খামচি	বিশেষ্য	
খামচিটার	খামচি	বিশেষ্য	
খাটে	খাট	বিশেষ্য	
খাটের	খাট	বিশেষ্য	
খাটই	খাট	বিশেষ্য	
খাটটার	খাট	বিশেষ্য	
খাটটা	খাট	বিশেষ্য	
খাটটি	খাট	বিশেষ্য	
খাটটির	খাট	বিশেষ্য	
খন্ডে	খন্ড	বিশেষ্য	
খন্ডের	খন্ড	বিশেষ্য	
খন্ডটি	খন্ড	বিশেষ্য	
খন্ডকে	খন্ড	বিশেষ্য	
খন্ডটিতে	খন্ড	বিশেষ্য	
খরচের	খরচ	বিশেষ্য	
খরগোশকে	খরগোশ	বিশেষ্য	
খরগোশের	খরগোশ	বিশেষ্য	
খরগোশটা	খরগোশ	বিশেষ্য	
খরগোশটি	খরগোশ	বিশেষ্য	
খরগোশটার	খরগোশ	বিশেষ্য	
খরগোশটির	খরগোশ	বিশেষ্য	
খরগোশদের	খরগোশ	বিশেষ্য	
খতমে	খতম	বিশেষ্য	
খতমের	খতম	বিশেষ্য	
খতমকে	খতম	বিশেষ্য	
খতমই	খতম	বিশেষ্য	
খতমেই	খতম	বিশেষ্য	
খড়ে	খড়	বিশেষ্য	
খড়ের	খড়	বিশেষ্য	
খড়ই	খড়	বিশেষ্য	
খড়ির	খড়	বিশেষ্য	
খড়েতে	খড়	বিশেষ্য	
খইয়ে	খই	বিশেষ্য	
খইয়ের	খই	বিশেষ্য	
খেই	খই	বিশেষ্য	খেই
খইতে	খই	বিশেষ্য	
খইতেই	খই	বিশেষ্য	
খামে	খাম	বিশেষ্য	
খামের	খাম	বিশেষ্য	
খামই	খাম	বিশেষ্য	
খামতেই	খাম	বিশেষ্য	
খামেতেই	খাম	বিশেষ্য	
খামারটি	খামার	বিশেষ্য	
খামারে	খামার	বিশেষ্য	
খামারের	খামার	বিশেষ্য	
খামারটিকে	খামার	বিশেষ্য	
খামারটা	খামার	বিশেষ্য	
খালে	খাল	বিশেষ্য	
খালের	খাল	বিশেষ্য	
খালই	খাল	বিশেষ্য	
খালটা	খাল	বিশেষ্য	
খালটাতে	খাল	বিশেষ্য	
খতিয়ে	খাত	বিশেষ্য	
খাতের	খাত	বিশেষ্য	
খাতই	খাত	বিশেষ্য	
খাতেই	খাত	বিশেষ্য	
খাতেরই	খাত	বিশেষ্য	
খড়িটা	খড়ি	বিশেষ্য	
খড়িতে	খড়ি	বিশেষ্য	
খড়ির	খড়ি	বিশেষ্য	খড়ি
খড়িই	খড়ি	বিশেষ্য	
খড়িতেই	খড়ি	বিশেষ্য	
খুশিই	খুশি	বিশেষ্য	
খুশিতে	খুশি	বিশেষ্য	
খুশিকে	খুশি	বিশেষ্য	
খুশিতো	খুশি	বিশেষ্য	
খুশির	খুশি	বিশেষ্য	
খুকুকে	খুকু	বিশেষ্য	
খুকুরে	খুকু	বিশেষ্য	
খুকুর	খুকু	বিশেষ্য	
খুকুটা	খুকু	বিশেষ্য	
খুকুই	খুকু	বিশেষ্য	
খনিতে	খনি	বিশেষ্য	
খনির	খনি	বিশেষ্য	
খনিটা	খনি	বিশেষ্য	
খনিটাতে	খনি	বিশেষ্য	
খনিই	খনি	বিশেষ্য	
খিচুড়ির	খিচুড়ি	বিশেষ্য	
খিচুড়িতে	খিচুড়ি	বিশেষ্য	
খিচুড়িটা	খিচুড়ি	বিশেষ্য	
খাটাশের	খাটাশ	বিশেষ্য	
খাটাশই	খাটাশ	বিশেষ্য	
খটাশটা	খাটাশ	বিশেষ্য	
খাটাশটি	খাটাশ	বিশেষ্য	
খাটাশটাকে	খাটাশ	বিশেষ্য	
খাদ্যর	খাদ্য	বিশেষ্য	
খাদ্যকে	খাদ্য	বিশেষ্য	
খাদ্যের	খাদ্য	বিশেষ্য	
খাদ্যতে	খাদ্য	বিশেষ্য	
খাদ্যই	খাদ্য	বিশেষ্য	
খেলবে	খেলা	ক্রিয়া	
খেলেছে	খেলা	ক্রিয়া	
খেলেছিল	খেলা	ক্রিয়া	
খেলেছিলাম	খেলা	ক্রিয়া	
খলেছেন	খেলা	ক্রিয়া	
খেলেছ	খেলা	ক্রিয়া	
খেলতে	খেলা	ক্রিয়া	
খেলতো	খেলা	ক্রিয়া	
খেলবো	খেলা	ক্রিয়া	
খাওয়াতে	খাওয়া	ক্রিয়া	
খাওয়ার	খাওয়া	ক্রিয়া	
খাওয়ান	খাওয়া	ক্রিয়া	
খাওনোর	খাওয়া	ক্রিয়া	
খাবে	খাওয়া	ক্রিয়া	
খাচ্ছি	খাওয়া	ক্রিয়া	
খেয়েছিলেন	খাওয়া	ক্রিয়া	
খেয়েছি	খাওয়া	ক্রিয়া	
খাবেন	খাওয়া	ক্রিয়া	
খাওয়ানো	খাওয়া	ক্রিয়া	
খাটোর	খাটো	বিশেষণ	
খাটোতে	খাটো	বিশেষণ	
খাটোই	খাটো	বিশেষণ	
খাটোত	খাটো	বিশেষণ	
খাটতো	খাটো	বিশেষণ	খাটা
খোকার	খোকা	বিশেষ্য	
খোকাকে	খোকা	বিশেষ্য	
খোকাই	খোকা	বিশেষ্য	
খোকারে	খোকা	বিশেষ্য	
খোকাটা	খোকা	বিশেষ্য	
খোসাটা	খোসা	বিশেষ্য	
খোসার	খোসা	বিশেষ্য	
খোসায়	খোসা	বিশেষ্য	
খোসাই	খোসা	বিশেষ্য	
খোসাতো	খোসা	বিশেষ্য	
খবরে	খবর	বিশেষ্য	
খবরের	খবর	বিশেষ্য	
খবরটি	খবর	বিশেষ্য	
খবরটা	খবর	বিশেষ্য	
খবরকে	খবর	বিশেষ্য	
খননে	খনন	বিশেষ্য	
খননের	খনন	বিশেষ্য	
খননই	খনন	বিশেষ্য	
খননতো	খনন	বিশেষ্য	
খননকে	খনন	বিশেষ্য	
খাতাটি	খাতা	বিশেষ্য	
খাতার	খাতা	বিশেষ্য	
খাতাই	খাতা	বিশেষ্য	
খাতাটা	খাতা	বিশেষ্য	
খুবই	খুব	ক্রিয়াবিশেষণ	
খুবি	খুব	ক্রিয়াবিশেষণ	খুবি
খুবত	খুব	ক্রিয়াবিশেষণ	খুবত
খুবতো	খুব	ক্রিয়াবিশেষণ	খুবতো
খুবরে	খুব	ক্রিয়াবিশেষণ	খুবরে
খাবারে	খাবার	বিশেষ্য	
খাবারের	খাবার	বিশেষ্য	
খাবারই	খাবার	বিশেষ্য	
খাবাতো	খাবার	বিশেষ্য	
খাবারকে	খাবার	বিশেষ্য	
খালুর	খালু	বিশেষ্য	
খালুকে	খালু	বিশেষ্য	
খালুরা	খালু	বিশেষ্য	
খালুদের	খালু	বিশেষ্য	
খালুই	খালু	বিশেষ্য	
গালে	গাল	বিশেষ্য	
গালি	গাল	বিশেষ্য	গালি
গালই	গাল	বিশেষ্য	
গালটা	গাল	বিশেষ্য	
গালের	গাল	বিশেষ্য	
খেজুরে	খেজুর	বিশেষ্য	
খেজুরের	খেজুর	বিশেষ্য	
খেজুরটা	খেজুর	বিশেষ্য	
খেজুরটি	খেজুর	বিশেষ্য	
খেজুরটির	খেজুর	বিশেষ্য	
ক্ষতির	ক্ষতি	বিশেষ্য	
ক্ষতিতে	ক্ষতি	বিশেষ্য	
ক্ষতিই	ক্ষতি	বিশেষ্য	
ক্ষতিটা	ক্ষতি	বিশেষ্য	
ক্ষতিকে	ক্ষতি	বিশেষ্য	
ক্ষতের	ক্ষত	বিশেষ্য	
ক্ষতে	ক্ষত	বিশেষ্য	
ক্ষতেই	ক্ষত	বিশেষ্য	
ক্ষতই	ক্ষত	বিশেষ্য	
ক্ষয়ে	ক্ষয়	ক্রিয়া	
ক্ষয়ই	ক্ষয়	ক্রিয়া	
ক্ষয়িত	ক্ষয়	ক্রিয়া	ক্ষয়িত
ক্ষয়ের	ক্ষয়	ক্রিয়া	
ক্ষয়কে	ক্ষয়	ক্রিয়া	
ক্ষমাই	ক্ষমা	বিশেষ্য	
ক্ষমাতে	ক্ষমা	বিশেষ্য	
ক্ষমার	ক্ষমা	বিশেষ্য	
ক্ষমায়	ক্ষমা	বিশেষ্য	
ক্ষমাতেই	ক্ষমা	বিশেষ্য	
গালকে	গাল	বিশেষ্য	
গরুর	গরু	বিশেষ্য	
গরুকে	গরু	বিশেষ্য	
গরুদের	গরু	বিশেষ্য	
গরুরা	গরু	বিশেষ্য	
গরুই	গরু	বিশেষ্য	
গুণের	গুণ	বিশেষ্য	
গুণেই	গুণ	বিশেষ্য	
গুণী	গুণ	বিশেষ্য	
গুণই	গুণ	বিশেষ্য	
গুণত	গুণ	বিশেষ্য	
গুণকে	গুণ	বিশেষ্য	
গণে	গণ	বিশেষ্য	
গণের	গণ	বিশেষ্য	
গণকে	গণ	বিশেষ্য	
গণই	গণ	বিশেষ্য	
গাভলাটা	গাভলা	বিশেষ্য	
গাভলাটি	গাভলা	বিশেষ্য	
গাভলাই	গাভলা	বিশেষ্য	
গাভলাতে	গাভলা	বিশেষ্য	
গণ্ডক	গণ্ড	বিশেষ্য	
গণ্ডদের	গণ্ড	বিশেষ্য	
গণ্ডি	গণ্ড	বিশেষ্য	গণ্ডি
গতকালে	গতকাল	বিশেষণ	
গতকালই	গতকাল	বিশেষণ	
গতকালকে	গতকাল	বিশেষণ	
গতকালের	গতকাল	বিশেষণ	
গতকালরে	গতকাল	বিশেষণ	
গতকালেই	গতকাল	বিশেষণ	
গতিই	গতি	বিশেষ্য	
গতিকে	গতি	বিশেষ্য	
গতিতে	গতি	বিশেষ্য	
গতিটা	গতি	বিশেষ্য	
গতির	গতি	বিশেষ্য	
গাভীটা	গাভী	বিশেষ্য	
গাভীর	গাভী	বিশেষ্য	
গাভীই	গাভী	বিশেষ্য	
গাভীকে	গাভী	বিশেষ্য	
গাভীটি	গাভী	বিশেষ্য	
গবেষিত	গবেষণা	বিশেষ্য	
গবেষণাতে	গবেষণা	বিশেষ্য	
গবেষণার	গবেষণা	বিশেষ্য	
গবেষণাই	গবেষণা	বিশেষ্য	
গবেষণাকে	গবেষণা	বিশেষ্য	
গর্ভে	গর্ভ	বিশেষ্য	
গর্ভের	গর্ভ	বিশেষ্য	
গর্ভবতী	গর্ভ	বিশেষ্য	
গর্ভপাতে	গর্ভপাত	বিশেষ্য	
গর্ভজাতে	গর্ভজাত	বিশেষ্য	
গর্ভধারণে	গর্ভধারণ	বিশেষ্য	
গর্ভধারণকে	গর্ভধারণ	বিশেষ্য	
গর্ভধারণটা	গর্ভধারণ	বিশেষ্য	
গর্ভধারণী	গর্ভধারণ	বিশেষ্য	
গর্ভধারণের	গর্ভধারণ	বিশেষ্য	
গলার	গলা	বিশেষ্য	
গলাতে	গলা	বিশেষ্য	
গলাই	গলা	বিশেষ্য	
গলায়ই	গলা	বিশেষ্য	
গলায়	গলা	বিশেষ্য	
গলানো	গলা	বিশেষ্য	
গল্পকে	গল্প	বিশেষ্য	
গল্পের	গল্প	বিশেষ্য	
গল্পে	গল্প	বিশেষ্য	
গল্পটা	গল্প	বিশেষ্য	
গল্পটি	গল্প	বিশেষ্য	
গল্পই	গল্প	বিশেষ্য	
গেয়েছে	গাওয়া	ক্রিয়া	
গেয়েছিল	গাওয়া	ক্রিয়া	
গেয়েছেন	গাওয়া	ক্রিয়া	
গেয়েছি	গাওয়া	ক্রিয়া	
গাব	গাওয়া	ক্রিয়া	
গাইবে	গাওয়া	ক্রিয়া	
গাইবেন	গাওয়া	ক্রিয়া	
গাওয়ার	গাওয়া	ক্রিয়া	
গাওয়ানোর	গাওয়া	ক্রিয়া	
গাওয়াতে	গাওয়া	ক্রিয়া	
গাওয়ানো	গাওয়া	ক্রিয়া	
গানেই	গান	বিশেষ্য	
গানের	গান	বিশেষ্য	
গানটি	গান	বিশেষ্য	
গানটির	গান	বিশেষ্য	
গানকে	গান	বিশেষ্য	
গানটা	গান	বিশেষ্য	
গানই	গান	বিশেষ্য	
গানেতে	গান	বিশেষ্য	
গাছের	গাছ	বিশেষ্য	
গাছে	গাছ	বিশেষ্য	
গাছকে	গাছ	বিশেষ্য	
গাছটা	গাছ	বিশেষ্য	
গাছটি	গাছ	বিশেষ্য	
গাছটার	গাছ	বিশেষ্য	
গাছটির	গাছ	বিশেষ্য	
গাছটিতে	গাছ	বিশেষ্য	
গাছেতে	গাছ	বিশেষ্য	
গাড়ির	গাড়ি	বিশেষ্য	
গাড়িটা	গাড়ি	বিশেষ্য	
গাড়িটাতে	গাড়ি	বিশেষ্য	
গাড়িটাতেই	গাড়ি	বিশেষ্য	
গাড়িতে	গাড়ি	বিশেষ্য	
গাড়িতেই	গাড়ি	বিশেষ্য	
গাড়িটি	গাড়ি	বিশেষ্য	
গাড়িটিকে	গাড়ি	বিশেষ্য	
গহীনে	গহীন	বিশেষ্য	
গহীনেও	গহীন	বিশেষ্য	
গহীনের	গহীন	বিশেষ্য	
গহীনেতে	গহীন	বিশেষ্য	
গহীনই	গহীন	বিশেষ্য	
গলদা	গলদ	বিশেষ্য	
গলদের	গলদ	বিশেষ্য	
গলদই	গলদ	বিশেষ্য	
গলদটা	গলদ	বিশেষ্য	
গলদটাকে	গলদ	বিশেষ্য	
গৃহকে	গৃহ	বিশেষ্য	
গৃহের	গৃহ	বিশেষ্য	
গৃহতে	গৃহ	বিশেষ্য	
গৃহটিকে	গৃহ	বিশেষ্য	
গৃহটি	গৃহ	বিশেষ্য	
গায়কের	গায়ক	বিশেষ্য	
গায়ককে	গায়ক	বিশেষ্য	
গায়কদের	গায়ক	বিশেষ্য	
গায়করা	গায়ক	বিশেষ্য	
গাইকার	গাইকা	বিশেষ্য	
গাইকাদের	গাইকা	বিশেষ্য	
গাইকারা	গাইকা	বিশেষ্য	
গাইকাকে	গাইকা	বিশেষ্য	
গাইকাই	গাইকা	বিশেষ্য	
গলাটা	গলা	বিশেষ্য	
গালই	গলা	বিশেষ্য	গাল
গোসলের	গোসল	বিশেষ্য	
গোসলই	গোসল	বিশেষ্য	
গিণতে	গণিত	বিশেষ্য	
গণিতের	গণিত	বিশেষ্য	
গণিতই	গণিত	বিশেষ্য	
গজবে	গজব	বিশেষ্য	
গজবের	গজব	বিশেষ্য	
গজবটা	গজব	বিশেষ্য	
গজবই	গজব	বিশেষ্য	
গজবকে	গজব	বিশেষ্য	
গজলটা	গজল	বিশেষ্য	
গজলটি	গজল	বিশেষ্য	
গজলের	গজল	বিশেষ্য	
গজলকে	গজল	বিশেষ্য	
গজলটার	গজল	বিশেষ্য	
গণনার	গণনা	বিশেষ্য	
গণনাই	গণনা	বিশেষ্য	
গণ্ডারকে	গণ্ডার	বিশেষ্য	
গণ্ডারের	গণ্ডার	বিশেষ্য	
গণ্ডারটা	গণ্ডার	বিশেষ্য	
গণ্ডারটি	গণ্ডার	বিশেষ্য	
গণ্ডারদের	গণ্ডার	বিশেষ্য	
গণ্ডাররা	গণ্ডার	বিশেষ্য	
গয়নার	গয়না	বিশেষ্য	
গয়নাতে	গয়না	বিশেষ্য	
গয়নাটি	গয়না	বিশেষ্য	
গয়নাটা	গয়না	বিশেষ্য	
গয়নাকে	গয়না	বিশেষ্য	
গরীবে	গরীব	বিশেষ্য	
গরীবকে	গরীব	বিশেষ্য	
গরীবের	গরীব	বিশেষ্য	
গরীবই	গরীব	বিশেষ্য	
গরীবরা	গরীব	বিশেষ্য	
গরমে	গরম	বিশেষ্য	
গরমকে	গরম	বিশেষ্য	
গরমই	গরম	বিশেষ্য	
গহনার	গহনা	বিশেষ্য	
গহনাতে	গহনা	বিশেষ্য	
গহনাটা	গহনা	বিশেষ্য	
গহনাটি	গহনা	বিশেষ্য	
গহনাকে	গহনা	বিশেষ্য	
গহনায়	গহনা	বিশেষ্য	
গাজরটা	গাজর	বিশেষ্য	
গাজরটি	গাজর	বিশেষ্য	
গাজরকে	গাজর	বিশেষ্য	
গাজরে	গাজর	বিশেষ্য	
গাজরই	গাজর	বিশেষ্য	
গাজরের	গাজর	বিশেষ্য	
গামছাটা	গামছা	বিশেষ্য	
গামছাটি	গামছা	বিশেষ্য	
গামছার	গামছা	বিশেষ্য	
গামছাতে	গামছা	বিশেষ্য	
গামছাই	গামছা	বিশেষ্য	
গামছায়	গামছা	বিশেষ্য	
গাথাই	গাথা	বিশেষ্য	
গাথার	গাথা	বিশেষ্য	
গামলার	গামলা	বিশেষ্য	
গামলাটা	গামলা	বিশেষ্য	
গামলায়	গামলা	বিশেষ্য	
গামলাতে	গামলা	বিশেষ্য	
গামলাটি	গামলা	বিশেষ্য	
গায়েনকে	গায়েন	বিশেষ্য	
গায়েনরা	গায়েন	বিশেষ্য	
গায়েনদের	গায়েন	বিশেষ্য	
গায়েনই	গায়েন	বিশেষ্য	
গোলাপে	গোলাপ	বিশেষ্য	
গোলাপকে	গোলাপ	বিশেষ্য	
গোলাপের	গোলাপ	বিশেষ্য	
গোলাপটি	গোলাপ	বিশেষ্য	
গোলাপই	গোলাপ	বিশেষ্য	
গোখরার	গোখরা	বিশেষ্য	
গোখরাটা	গোখরা	বিশেষ্য	
গোখরাটি	গোখরা	বিশেষ্য	
গোখরাই	গোখরা	বিশেষ্য	
গোলকে	গোলক	বিশেষ্য	
গোলকের	গোলক	বিশেষ্য	
গোলকটা	গোলক	বিশেষ্য	
গোলকটি	গোলক	বিশেষ্য	
গোলটা	গোল	বিশেষ্য	
গোলই	গোল	বিশেষ্য	
গোলটি	গোল	বিশেষ্য	
গোলটর	গোল	বিশেষ্য	
গোলটাকে	গোল	বিশেষ্য	
গোলটির	গোল	বিশেষ্য	
গ্রামে	গ্রাম	বিশেষ্য	
গ্রামটা	গ্রাম	বিশেষ্য	
গ্রামটি	গ্রাম	বিশেষ্য	
গ্রামকে	গ্রাম	বিশেষ্য	
গ্রামই	গ্রাম	বিশেষ্য	
গ্রহটা	গ্রহ	বিশেষ্য	
গ্রহটি	গ্রহ	বিশেষ্য	
গ্রহকে	গ্রহ	বিশেষ্য	
গ্রহই	গ্রহ	বিশেষ্য	
গ্রহতে	গ্রহ	বিশেষ্য	
গোহাড়টা	গোহাড়	বিশেষ্য	
গোহাড়টি	গোহাড়	বিশেষ্য	
গোহাড়কে	গোহাড়	বিশেষ্য	
গোহাড়ে	গোহাড়	বিশেষ্য	
গোহাড়ই	গোহাড়	বিশেষ্য	
গোশতই	গোশত	বিশেষ্য	
গোশতের	গোশত	বিশেষ্য	
গোশততে	গোশত	বিশেষ্য	
গোশতকে	গোশত	বিশেষ্য	
গোপনে	গোপন	বিশেষ্য	গোপনে
গোপনের	গোপন	বিশেষ্য	
গড়ালির	গড়ালি	বিশেষ্য	
গড়ালিটা	গড়ালি	বিশেষ্য	
গড়ালিতে	গড়ালি	বিশেষ্য	
গুহার	গুহা	বিশেষ্য	
গুহাতে	গুহা	বিশেষ্য	
গুহাকে	গুহা	বিশেষ্য	
গুহাটা	গুহা	বিশেষ্য	
গুহাটি	গুহা	বিশেষ্য	
গোয়েন্দার	গোয়েন্দা	বিশেষ্য	
গোয়েন্দাদের	গোয়েন্দা	বিশেষ্য	
গোয়েন্দারা	গোয়েন্দা	বিশেষ্য	
ঘটককে	ঘটক	বিশেষ্য	
ঘটককের	ঘটক	বিশেষ্য	
ঘটকরা	ঘটক	বিশেষ্য	
ঘটকদের	ঘটক	বিশেষ্য	
ঘটকই	ঘটক	বিশেষ্য	
ঘড়ির	ঘড়ি	বিশেষ্য	
ঘড়িটা	ঘড়ি	বিশেষ্য	
ঘড়িটি	ঘড়ি	বিশেষ্য	
ঘড়িতে	ঘড়ি	বিশেষ্য	
ঘড়িটার	ঘড়ি	বিশেষ্য	
ঘড়িই	ঘড়ি	বিশেষ্য	
ঘনকটা	ঘনক	বিশেষ্য	
ঘনকটি	ঘনক	বিশেষ্য	
ঘনককে	ঘনক	বিশেষ্য	
ঘনককের	ঘনক	বিশেষ্য	
ঘনকই	ঘনক	বিশেষ্য	
ঘনকটাতে	ঘনক	বিশেষ্য	
ঘড়িয়ালে	ঘড়িয়াল	বিশেষ্য	
ঘড়িয়ালদের	ঘড়িয়াল	বিশেষ্য	
ঘড়িয়ালরা	ঘড়িয়াল	বিশেষ্য	
ঘড়িয়ালকে	ঘড়িয়াল	বিশেষ্য	
ঘড়িয়ালটা	ঘড়িয়াল	বিশেষ্য	
ঘাতকদের	ঘাতক	বিশেষ্য	
ঘাতকই	ঘাতক	বিশেষ্য	
ঘাতককে	ঘাতক	বিশেষ্য	
ঘাতকের	ঘাতক	বিশেষ্য	
ঘুসিটা	ঘুসি	বিশেষ্য	
ঘুসির	ঘুসি	বিশেষ্য	
ঘুসিই	ঘুসি	বিশেষ্য	
ঘুষের	ঘুষ	বিশেষ্য	
ঘুষই	ঘুষ	বিশেষ্য	
ঘোষককে	ঘোষক	বিশেষ্য	
ঘোষকের	ঘোষক	বিশেষ্য	
ঘোষকরা	ঘোষক	বিশেষ্য	
ঘোষকদের	ঘোষক	বিশেষ্য	
ঘোষকই	ঘোষক	বিশেষ্য	
ঘোমটার	ঘোমটা	বিশেষ্য	
ঘোমটাই	ঘোমটা	বিশেষ্য	
ঘোমটাতে	ঘোমটা	বিশেষ্য	
ঘুরে	ঘুর	বিশেষ্য	
ঘুরা	ঘুর	বিশেষ্য	
ঘুরতে	ঘুর	বিশেষ্য	
ঘনফুটে	ঘনফুট	বিশেষ্য	
ঘনফুটের	ঘনফুট	বিশেষ্য	
ঘনফুটই	ঘনফুট	বিশেষ্য	
ঘনমূলে	ঘনমূল	বিশেষ্য	
ঘনমূলের	ঘনমূল	বিশেষ্য	
ঘনমূলই	ঘনমূল	বিশেষ্য	
ঘষার	ঘষা	বিশেষ্য	
ঘষাই	ঘষা	বিশেষ্য	
ঘষতে	ঘষা	বিশেষ্য	
ঘোষকে	ঘোষ	বিশেষ্য	
ঘোষই	ঘোষ	বিশেষ্য	
ঘোষরা	ঘোষ	বিশেষ্য	
ঘোড়ার	ঘোড়া	বিশেষ্য	
ঘোড়াটা	ঘোড়া	বিশেষ্য	
ঘোড়াটি	ঘোড়া	বিশেষ্য	
ঘোড়াকে	ঘোড়া	বিশেষ্য	
ঘোড়াই	ঘোড়া	বিশেষ্য	
ঘোড়াদের	ঘোড়া	বিশেষ্য	
ঘুঘুর	ঘুঘু	বিশেষ্য	
ঘুঘুকে	ঘুঘু	বিশেষ্য	
ঘুঘুই	ঘুঘু	বিশেষ্য	
ঘুঘুরা	ঘুঘু	বিশেষ্য	
ঘুঘুটি	ঘুঘু	বিশেষ্য	
ঘুঘুটা	ঘুঘু	বিশেষ্য	
ঘুলার	ঘুলা	বিশেষ্য	
ঘুলাতে	ঘুলা	বিশেষ্য	
ঘুলাই	ঘুলা	বিশেষ্য	
ঘুমান	ঘুম	বিশেষ্য	
ঘুমিয়েছে	ঘুম	বিশেষ্য	
ঘুমাচ্ছিলেন	ঘুম	বিশেষ্য	
ঘুমাবেন	ঘুম	বিশেষ্য	
ঘুমিয়ে	ঘুম	বিশেষ্য	
ঘুমরে	ঘুম	বিশেষ্য	
ঘুমকে	ঘুম	বিশেষ্য	
ঘুমের	ঘুম	বিশেষ্য	
ঘুমাতে	ঘুম	বিশেষ্য	
ঘুমাব	ঘুম	বিশেষ্য	
ঘুমে	ঘুম	বিশেষ্য	
ঘাটতি	ঘাট	বিশেষ্য	ঘাটতি
ঘাটের	ঘাট	বিশেষ্য	
ঘাটকে	ঘাট	বিশেষ্য	
ঘাটই	ঘাট	বিশেষ্য	
ঘাটা	ঘাট	বিশেষ্য	ঘাটা
ঘাটে	ঘাট	বিশেষ্য	
ঘামানো	ঘাম	বিশেষ্য	ঘামা
ঘামাচ্ছিল	ঘাম	বিশেষ্য	ঘামা
ঘামাবে	ঘাম	বিশেষ্য	ঘামা
ঘামতে	ঘাম	বিশেষ্য	ঘামা
ঘামে	ঘাম	বিশেষ্য	
ঘামের	ঘাম	বিশেষ্য	
ঘামই	ঘাম	বিশেষ্য	
ঘ্রানে	ঘ্রান	বিশেষ্য	
ঘ্রানের	ঘ্রান	বিশেষ্য	
ঘ্রানই	ঘ্রান	বিশেষ্য	
ঘ্রানটা	ঘ্রান	বিশেষ্য	
ঘ্রানকে	ঘ্রান	বিশেষ্য	
ঘূর্ণিত	ঘূর্ণি	বিশেষ্য	ঘূর্ণিত
ঘূর্ণির	ঘূর্ণি	বিশেষ্য	
ঘূর্ণিকে	ঘূর্ণি	বিশেষ্য	
ঘূর্ণিই	ঘূর্ণি	বিশেষ্য	
ঘৃণার	ঘৃণা	বিশেষ্য	
ঘৃণাকে	ঘৃণা	বিশেষ্য	
ঘৃণাতে	ঘৃণা	বিশেষ্য	
ঘৃণাই	ঘৃণা	বিশেষ্য	
ঘৃণিত	ঘৃণা	বিশেষ্য	ঘৃণিত
ঘরের	ঘর	বিশেষ্য	
ঘরে	ঘর	বিশেষ্য	
ঘরটা	ঘর	বিশেষ্য	
ঘরটি	ঘর	বিশেষ্য	
ঘরই	ঘর	বিশেষ্য	
ঘটনার	ঘটনা	বিশেষ্য	
ঘটনাকে	ঘটনা	বিশেষ্য	
ঘটনাতে	ঘটনা	বিশেষ্য	
ঘটনাই	ঘটনা	বিশেষ্য	
ঘটনাতেই	ঘটনা	বিশেষ্য	
ঘাসে	ঘাস	বিশেষ্য	
ঘাসের	ঘাস	বিশেষ্য	
ঘাসই	ঘাস	বিশেষ্য	
ঘাসটা	ঘাস	বিশেষ্য	
ঘাসটি	ঘাস	বিশেষ্য	
ঘাড়ে	ঘাড়	বিশেষ্য	
ঘাড়ের	ঘাড়	বিশেষ্য	
ঘড়টা	ঘাড়	বিশেষ্য	
ঘাড়ই	ঘাড়	বিশেষ্য	
ঘাড়েতে	ঘাড়	বিশেষ্য	
ঘুড়ির	ঘুড়ি	বিশেষ্য	
ঘড়িতে	ঘুড়ি	বিশেষ্য	ঘড়ি
ঘুড়িটা	ঘুড়ি	বিশেষ্য	
ঘুড়িয়ে	ঘুড়ি	বিশেষ্য	
ঘুড়িটি	ঘুড়ি	বিশেষ্য	
ঘাতকের	ঘাত	বিশেষ্য	ঘাতক
ঘাতে	ঘাত	বিশেষ্য	
ঘাতটির	ঘাত	বিশেষ্য	
ঘাতটার	ঘাত	বিশেষ্য	
ঘাতকে	ঘাত	বিশেষ্য	
ঘাতের	ঘাত	বিশেষ্য	
ঘাতটি	ঘাত	বিশেষ্য	
ঘাতই	ঘাত	বিশেষ্য	
চাবিটা	চাবি	বিশেষ্য	
চাবিটি	চাবি	বিশেষ্য	
চুম্বককে	চুম্বক	বিশেষ্য	
চুম্বককের	চুম্বক	বিশেষ্য	
চুম্বকটি	চুম্বক	বিশেষ্য	
চুম্বকটির	চুম্বক	বিশেষ্য	
চুম্বকটা	চুম্বক	বিশেষ্য	
চিলতে	চিল	বিশেষ্য	
চিলের	চিল	বিশেষ্য	
চিলটা	চিল	বিশেষ্য	
চিলকে	চিল	বিশেষ্য	
চিলদের	চিল	বিশেষ্য	
চিলই	চিল	বিশেষ্য	
চাচারে	চাচা	বিশেষ্য	
চাচাকে	চাচা	বিশেষ্য	
চাচাই	চাচা	বিশেষ্য	
চাচাতো	চাচা	বিশেষ্য	
চাচার	চাচা	বিশেষ্য	
চাবুকটি	চাবুক	বিশেষ্য	
চাবুকের	চাবুক	বিশেষ্য	
চাবুকে	চাবুক	বিশেষ্য	
চাবুকই	চাবুক	বিশেষ্য	
চাঁদে	চাঁদ	বিশেষ্য	
চাঁদকে	চাঁদ	বিশেষ্য	
চাঁদই	চাঁদ	বিশেষ্য	
চাঁদের	চাঁদ	বিশেষ্য	
চাঁদটা	চাঁদ	বিশেষ্য	
চাকরিই	চাকরি	বিশেষ্য	
চাকরিটার	চাকরি	বিশেষ্য	
চাকরিটা	চাকরি	বিশেষ্য	
চাকরির	চাকরি	বিশেষ্য	
চাকরিতে	চাকরি	বিশেষ্য	
চাকরে	চাকর	বিশেষ্য	
চাকরের	চাকর	বিশেষ্য	
চাকরটি	চাকর	বিশেষ্য	
চাকরকে	চাকর	বিশেষ্য	
চালকে	চালক	বিশেষ্য	
চালেকর	চালক	বিশেষ্য	
চালকটি	চালক	বিশেষ্য	
চালকই	চালক	বিশেষ্য	
চালে	চাল	বিশেষ্য	
চালের	চাল	বিশেষ্য	
চালই	চাল	বিশেষ্য	
চক্ষুসুল	চক্ষু	বিশেষ্য	চক্ষুসুল
চক্ষুকে	চক্ষু	বিশেষ্য	
চক্ষুগোচর	চক্ষু	বিশেষ্য	চক্ষুগোচর
চক্রটা	চক্র	বিশেষ্য	
চক্রবাক	চক্র	বিশেষ্য	চক্রবাক
চক্রান্ত	চক্র	বিশেষ্য	চক্রান্ত
চক্রনাভি	চক্র	বিশেষ্য	চক্রনাভি
চড়ে	চড়া	ক্রিয়া	
চড়াও	চড়া	ক্রিয়া	
চড়েই	চড়া	ক্রিয়া	
চড়াই	চড়া	ক্রিয়া	
চড়তে	চড়া	ক্রিয়া	
চড়াতে	চড়া	ক্রিয়া	
চড়ানো	চড়া	ক্রিয়া	
চরিত্রে	চরিত্র	বিশেষ্য	
চরিত্রেই	চরিত্র	বিশেষ্য	
চরিত্রই	চরিত্র	বিশেষ্য	
চরিত্রটা	চরিত্র	বিশেষ্য	
চরিত্রের	চরিত্র	বিশেষ্য	
চরিত্রকে	চরিত্র	বিশেষ্য	
চেয়েছিল	চাওয়া	ক্রিয়া	
চেয়েছি	চাওয়া	ক্রিয়া	
চাইবো	চাওয়া	ক্রিয়া	
চাইবে	চাওয়া	ক্রিয়া	
চাইছিলেন	চাওয়া	ক্রিয়া	
চোখের	চোখ	বিশেষ্য	
চোখে	চোখ	বিশেষ্য	
চোখটি	চোখ	বিশেষ্য	
চোখটির	চোখ	বিশেষ্য	
চোখটা	চোখ	বিশেষ্য	
চোখই	চোখ	বিশেষ্য	
চলে	চলা	ক্রিয়া	
চলতি	চলা	ক্রিয়া	
চলছে	চলা	ক্রিয়া	
চলতেই	চলা	ক্রিয়া	
চলতেছে	চলা	ক্রিয়া	
চলিতেন	চলা	ক্রিয়া	
চলিতেছেন	চলা	ক্রিয়া	
চলছিলো	চলা	ক্রিয়া	
চলবে	চলা	ক্রিয়া	
চলবেই	চলা	ক্রিয়া	
চলি	চলা	ক্রিয়া	
চড়ুইরা	চড়ুই	বিশেষ্য	
চড়ুইদের	চড়ুই	বিশেষ্য	
চড়ুটা	চড়ুই	বিশেষ্য	
চড়ুইকে	চড়ুই	বিশেষ্য	
চড়ুটি	চড়ুই	বিশেষ্য	
চড়া	চড়	বিশেষ্য	
চড়টা	চড়	বিশেষ্য	
চড়ই	চড়	বিশেষ্য	
চমকের	চমক	বিশেষ্য	
চমকে	চমক	বিশেষ্য	
চমকেই	চমক	বিশেষ্য	
চমকটা	চমক	বিশেষ্য	
চমকই	চমক	বিশেষ্য	
চামচাটা	চামচা	বিশেষ্য	
চামচামির	চামচা	বিশেষ্য	
চামচাটাকে	চামচা	বিশেষ্য	
চামচাদের	চামচা	বিশেষ্য	
চামচাই	চামচা	বিশেষ্য	
চামচটা	চামচ	বিশেষ্য	
চামচটি	চামচ	বিশেষ্য	
চামচকে	চামচ	বিশেষ্য	
চামচে	চামচ	বিশেষ্য	
চামচই	চামচ	বিশেষ্য	
চামিচটি	চামিচ	বিশেষ্য	
চামিচটিতে	চামিচ	বিশেষ্য	
চামিচে	চামিচ	বিশেষ্য	
চামিচকে	চামিচ	বিশেষ্য	
চামিচের	চামিচ	বিশেষ্য	
চামড়ার	চামড়া	বিশেষ্য	
চামড়াতে	চামড়া	বিশেষ্য	
চামড়াটি	চামড়া	বিশেষ্য	
চামড়াটা	চামড়া	বিশেষ্য	
চামড়ায়	চামড়া	বিশেষ্য	
চামড়াই	চামড়া	বিশেষ্য	
চওড়ার	চওড়া	বিশেষ্য	
চওড়াতে	চওড়া	বিশেষ্য	
চওড়াটা	চওড়া	বিশেষ্য	
চওড়াটি	চওড়া	বিশেষ্য	
চকে	চক	বিশেষ্য	
চকের	চক	বিশেষ্য	
চকটি	চক	বিশেষ্য	
চকটা	চক	বিশেষ্য	
চকই	চক	বিশেষ্য	
চটে	চট	বিশেষ্য	
চটের	চট	বিশেষ্য	
চটটা	চট	বিশেষ্য	
চটটি	চট	বিশেষ্য	
চটই	চট	বিশেষ্য	
চটকে	চট	বিশেষ্য	
চটপটিটি	চটপটি	বিশেষ্য	
চটপটিটা	চটপটি	বিশেষ্য	
চটপটিতে	চটপটি	বিশেষ্য	
চটপটির	চটপটি	বিশেষ্য	
চটপটিই	চটপটি	বিশেষ্য	
চরকিটা	চরকি	বিশেষ্য	
চরকিটি	চরকি	বিশেষ্য	
চরকিটির	চরকি	বিশেষ্য	
চরকিকে	চরকি	বিশেষ্য	
চরকিই	চরকি	বিশেষ্য	
চরকাটি	চরকা	বিশেষ্য	
চরকাটা	চরকা	বিশেষ্য	
চরকাতে	চরকা	বিশেষ্য	
চরকার	চরকা	বিশেষ্য	
চরকাই	চরকা	বিশেষ্য	
চাচির	চাচি	বিশেষ্য	
কে	চাচি	বিশেষ্য	
চাচিরা	চাচি	বিশেষ্য	
চাচিদের	চাচি	বিশেষ্য	
চাচিই	চাচি	বিশেষ্য	
চাকার	চাকা	বিশেষ্য	
চাকাতে	চাকা	বিশেষ্য	
চাকাটা	চাকা	বিশেষ্য	
চাকাটি	চাকা	বিশেষ্য	
চাকাই	চাকা	বিশেষ্য	
চাকুর	চাকু	বিশেষ্য	
চাকুটা	চাকু	বিশেষ্য	
চাকুটি	চাকু	বিশেষ্য	
চাকুতে	চাকু	বিশেষ্য	
চাকুই	চাকু	বিশেষ্য	
চাদরে	চাদর	বিশেষ্য	
চাদরকে	চাদর	বিশেষ্য	
চাদরটা	চাদর	বিশেষ্য	
চাদরটি	চাদর	বিশেষ্য	
চাদরই	চাদর	বিশেষ্য	
চাষে	চাষ	বিশেষ্য	
চাষের	চাষ	বিশেষ্য	
চাষকে	চাষ	বিশেষ্য	
চাষই	চাষ	বিশেষ্য	
চুলাতে	চুলা	বিশেষ্য	
চুলার	চুলা	বিশেষ্য	
চুলাটা	চুলা	বিশেষ্য	
চুলাটি	চুলা	বিশেষ্য	
চুলাই	চুলা	বিশেষ্য	
চালাকই	চালাক	বিশেষ্য	
চালাকের	চালাক	বিশেষ্য	
চুলে	চুল	বিশেষ্য	
চুলের	চুল	বিশেষ্য	
চুলই	চুল	বিশেষ্য	
চাহিদার	চাহিদা	বিশেষ্য	
চাহিদাই	চাহিদা	বিশেষ্য	
চাহিদাকে	চাহিদা	বিশেষ্য	
চিকার	চিকা	বিশেষ্য	
চিকাটা	চিকা	বিশেষ্য	
চিকাটি	চিকা	বিশেষ্য	
চিকাকদের	চিকা	বিশেষ্য	
চিকাই	চিকা	বিশেষ্য	
চিতলটা	চিতল	বিশেষ্য	
চিতলটি	চিতল	বিশেষ্য	
চিতলকে	চিতল	বিশেষ্য	
চিতলের	চিতল	বিশেষ্য	
চিতলই	চিতল	বিশেষ্য	
চিতার	চিতা	বিশেষ্য	
চিতাকে	চিতা	বিশেষ্য	
চিতাটা	চিতা	বিশেষ্য	
চিতাটি	চিতা	বিশেষ্য	
চিতাই	চিতা	বিশেষ্য	
চিনির	চিনি	বিশেষ্য	
চিনিতে	চিনি	বিশেষ্য	
চিনিই	চিনি	বিশেষ্য	
চিরুনিই	চিরুনি	বিশেষ্য	
চিরুনির	চিরুনি	বিশেষ্য	
চিরুনিটা	চিরুনি	বিশেষ্য	
চিরুনিতে	চিরুনি	বিশেষ্য	
চিরুনিটি	চিরুনি	বিশেষ্য	
চিরতার	চিরতা	বিশেষ্য	
চিরতায়	চিরতা	বিশেষ্য	
চিরতাকে	চিরতা	বিশেষ্য	
চিরতাটা	চিরতা	বিশেষ্য	
চিরতাটি	চিরতা	বিশেষ্য	
চুনে	চুন	বিশেষ্য	
চুনের	চুন	বিশেষ্য	
চুনই	চুন	বিশেষ্য	
চুনকে	চুন	বিশেষ্য	
চুড়িটা	চুড়ি	বিশেষ্য	
চুড়িতে	চুড়ি	বিশেষ্য	
চুড়ির	চুড়ি	বিশেষ্য	
চুড়িটি	চুড়ি	বিশেষ্য	
চুড়িই	চুড়ি	বিশেষ্য	
চেইনে	চেইন	বিশেষ্য	
চেইনটি	চেইন	বিশেষ্য	
চেইনটা	চেইন	বিশেষ্য	
চেইনই	চেইন	বিশেষ্য	
চেইনের	চেইন	বিশেষ্য	
চোরটা	চোর	বিশেষ্য	
চোরের	চোর	বিশেষ্য	
চোরটি	চোর	বিশেষ্য	
চোরকে	চোর	বিশেষ্য	
চোরই	চোর	বিশেষ্য	
চেলার	চেলা	বিশেষ্য	
চেলাই	চেলা	বিশেষ্য	
চেলাটা	চেলা	বিশেষ্য	
চেলাটি	চেলা	বিশেষ্য	
ছক্কার	ছক্কা	বিশেষ্য	
ছক্কাটা	ছক্কা	বিশেষ্য	
ছক্কাটি	ছক্কা	বিশেষ্য	
ছক্কাই	ছক্কা	বিশেষ্য	
ছক্কায়	ছক্কা	বিশেষ্য	
ছটাকে	ছটাক	বিশেষ্য	
ছটাকই	ছটাক	বিশেষ্য	
ছটাকের	ছটাক	বিশেষ্য	
ছটাকেই	ছটাক	বিশেষ্য	
ছুড়িটা	ছুড়ি	বিশেষ্য	
ছুড়িটি	ছুড়ি	বিশেষ্য	
ছুড়িতে	ছুড়ি	বিশেষ্য	
ছুড়িই	ছুড়ি	বিশেষ্য	
ছুড়িটার	ছুড়ি	বিশেষ্য	
ছনে	ছন	বিশেষ্য	
ছনের	ছন	বিশেষ্য	
ছনই	ছন	বিশেষ্য	
ছনটি	ছন	বিশেষ্য	
ছনটায়	ছন	বিশেষ্য	
ছয়ে	ছয়	বিশেষ্য	
ছয়ই	ছয়	বিশেষ্য	
ছয়টা	ছয়	বিশেষ্য	
ছাতাটা	ছাতা	বিশেষ্য	
ছাতাটি	ছাতা	বিশেষ্য	
ছাতার	ছাতা	বিশেষ্য	
ছাতাতে	ছাতা	বিশেষ্য	
ছাতাই	ছাতা	বিশেষ্য	
ছাঁচে	ছাঁচ	বিশেষ্য	
ছাঁচের	ছাঁচ	বিশেষ্য	
ছাঁচই	ছাঁচ	বিশেষ্য	
ছাঁচটা	ছাঁচ	বিশেষ্য	
ছাঁচটি	ছাঁচ	বিশেষ্য	
ছাঁকনাটি	ছাঁকনা	বিশেষ্য	
ছাঁকনাটা	ছাঁকনা	বিশেষ্য	
ছাঁকনার	ছাঁকনা	বিশেষ্য	
ছাঁকনাতে	ছাঁকনা	বিশেষ্য	
ছাঁকনাই	ছাঁকনা	বিশেষ্য	
ছাইতে	ছাই	বিশেষ্য	
ছাইয়ে	ছাই	বিশেষ্য	
ছাইকে	ছাই	বিশেষ্য	
ছাদে	ছাদ	বিশেষ্য	
ছাদের	ছাদ	বিশেষ্য	
ছাদটা	ছাদ	বিশেষ্য	
ছাদটি	ছাদ	বিশেষ্য	
ছাদই	ছাদ	বিশেষ্য	
ছাউনির	ছাউনি	বিশেষ্য	
ছাউনিটা	ছাউনি	বিশেষ্য	
ছাউনিটি	ছাউনি	বিশেষ্য	
ছাউনিতে	ছাউনি	বিশেষ্য	
ছাঁটায়	ছাঁটা	বিশেষ্য	
ছাঁটার	ছাঁটা	বিশেষ্য	
ছাঁটাই	ছাঁটা	বিশেষ্য	
ছারখারই	ছারখার	বিশেষ্য	
ছারখারে	ছারখার	বিশেষ্য	
ছতরে	ছতর	বিশেষ্য	
ছতরটি	ছতর	বিশেষ্য	
ছতরই	ছতর	বিশেষ্য	
ছতরকে	ছতর	বিশেষ্য	
ছালটটি	ছালট	বিশেষ্য	
ছলটে	ছালট	বিশেষ্য	
ছালটের	ছালট	বিশেষ্য	
ছালটকে	ছালট	বিশেষ্য	
ছালটই	ছালট	বিশেষ্য	
ছালার	ছালা	বিশেষ্য	
ছালাটা	ছালা	বিশেষ্য	
ছালাতে	ছালা	বিশেষ্য	
ছালাটি	ছালা	বিশেষ্য	
ছালায়	ছালা	বিশেষ্য	
ছিকাটি	ছিকা	বিশেষ্য	
ছিকাতে	ছিকা	বিশেষ্য	
ছিকার	ছিকা	বিশেষ্য	
ছিকাটা	ছিকা	বিশেষ্য	
ছিকাই	ছিকা	বিশেষ্য	
ছোবড়ার	ছোবড়া	বিশেষ্য	
ছোবড়াতে	ছোবড়া	বিশেষ্য	
ছোবড়াটি	ছোবড়া	বিশেষ্য	
ছিয়াশিতে	ছিয়াশি	বিশেষ্য	
ছিয়াশিই	ছিয়াশি	বিশেষ্য	
ছালে	ছাল	বিশেষ্য	
ছালকে	ছাল	বিশেষ্য	
ছালটা	ছাল	বিশেষ্য	
ছালটি	ছাল	বিশেষ্য	
ছালই	ছাল	বিশেষ্য	
ছিপে	ছিপ	বিশেষ্য	
ছিপের	ছিপ	বিশেষ্য	
ছিপটা	ছিপ	বিশেষ্য	
ছিপটি	ছিপ	বিশেষ্য	
ছিপই	ছিপ	বিশেষ্য	
ছুকরিকে	ছুকরি	বিশেষ্য	
ছুকরির	ছুকরি	বিশেষ্য	
ছুয়ায়	ছুয়া	বিশেষ্য	
ছুয়াতে	ছুয়া	বিশেষ্য	
ছুয়াই	ছুয়া	বিশেষ্য	
ছেলেটা	ছেলে	বিশেষ্য	
ছেলেটি	ছেলে	বিশেষ্য	
ছেলের	ছেলে	বিশেষ্য	
ছেলেকে	ছেলে	বিশেষ্য	
ছোঁড়াটি	ছোঁড়া	বিশেষ্য	
ছোঁড়াকে	ছোঁড়া	বিশেষ্য	
ছোঁড়ার	ছোঁড়া	বিশেষ্য	
ছোঁড়াটা	ছোঁড়া	বিশেষ্য	
ছোঁড়াই	ছোঁড়া	বিশেষ্য	
ছোপে	ছোপ	বিশেষ্য	
ছোপের	ছোপ	বিশেষ্য	
ছেমড়ার	ছেমড়া	বিশেষ্য	
ছেমড়াকে	ছেমড়া	বিশেষ্য	
ছেমড়াটি	ছেমড়া	বিশেষ্য	
ছেমড়াটা	ছেমড়া	বিশেষ্য	
ছোলার	ছোলা	বিশেষ্য	
ছোলাটি	ছোলা	বিশেষ্য	
ছোলাটা	ছোলা	বিশেষ্য	
ছোলাতে	ছোলা	বিশেষ্য	
ছোলাই	ছোলা	বিশেষ্য	
ছোলাকে	ছোলা	বিশেষ্য	
ছাগলের	ছাগল	বিশেষ্য	
ছাগলে	ছাগল	বিশেষ্য	
ছাগলটি	ছাগল	বিশেষ্য	
ছাগলটা	ছাগল	বিশেষ্য	
ছাগলরা	ছাগল	বিশেষ্য	
ছাগলই	ছাগল	বিশেষ্য	
ছাগলকে	ছাগল	বিশেষ্য	
ছাগলদের	ছাগল	বিশেষ্য	
ছাগলটার	ছাগল	বিশেষ্য	
ছাগলটির	ছাগল	বিশেষ্য	
ছাএে	ছাত্র	বিশেষ্য	
ছাত্রের	ছাত্র	বিশেষ্য	
ছাত্রটা	ছাত্র	বিশেষ্য	
ছরিয়েছে	ছাড়া	ক্রিয়া	ছড়ানো
ছরাবে	ছাড়া	ক্রিয়া	ছড়ানো
ছড়াচ্ছিলেন	ছাড়া	ক্রিয়া	ছড়ানো
ছড়রাবেন	ছাড়া	ক্রিয়া	ছড়ানো
ছুটিতে	ছুটি	বিশেষ্য	
ছুটির	ছুটি	বিশেষ্য	
ছুটিতেই	ছুটি	বিশেষ্য	
ছুটিকে	ছুটি	বিশেষ্য	
ছড়ার	ছড়া	বিশেষ্য	
ছড়ায়	ছড়া	বিশেষ্য	
ছড়াটি	ছড়া	বিশেষ্য	
ছড়াটিকে	ছড়া	বিশেষ্য	
ছবির	ছবি	বিশেষ্য	
ছবিতে	ছবি	বিশেষ্য	
ছবিটি	ছবি	বিশেষ্য	
ছিবই	ছবি	বিশেষ্য	
ছবিটাকে	ছবি	বিশেষ্য	
ছবিকে	ছবি	বিশেষ্য	
ছবিটিতে	ছবি	বিশেষ্য	
ছবিটা	ছবি	বিশেষ্য	
ছকের	ছক	বিশেষ্য	
ছকে	ছক	বিশেষ্য	
ছকটি	ছক	বিশেষ্য	
ছকটির	ছক	বিশেষ্য	
ছন্দে	ছন্দ	বিশেষ্য	
ছন্দের	ছন্দ	বিশেষ্য	
ছন্দটি	ছন্দ	বিশেষ্য	
ছন্দই	ছন্দ	বিশেষ্য	
ছন্দটিতে	ছন্দ	বিশেষ্য	
ছাপে	ছাপ	বিশেষ্য	
ছাপিয়ে	ছাপ	বিশেষ্য	
ছাপের	ছাপ	বিশেষ্য	
ছাপা	ছাপ	বিশেষ্য	
ছাপাতে	ছাপ	বিশেষ্য	
ছড়ায়	ছায়া	বিশেষ্য	
ছায়াতে	ছায়া	বিশেষ্য	
ছায়ার	ছায়া	বিশেষ্য	
ছায়াতলে	ছায়া	বিশেষ্য	
ছায়াতেই	ছায়া	বিশেষ্য	
জাপানে	জাপান	বিশেষ্য	
জাপানের	জাপান	বিশেষ্য	
জাপানি	জাপান	বিশেষ্য	
জাপানেই	জাপান	বিশেষ্য	
জংশনে	জংশন	বিশেষ্য	
জংশনের	জংশন	বিশেষ্য	
জংশনটি	জংশন	বিশেষ্য	
জড়ানো	জরিত	বিশেষ্য	
জড়িয়েছে	জরিত	বিশেষ্য	
জড়াবে	জরিত	বিশেষ্য	
জরিত	জরিত	বিশেষণ	
জনে	জন	বিশেষ্য	
জনের	জন	বিশেষ্য	
জন্য	জন	বিশেষণ	
জনতা	জন	বিশেষ্য	
জন্মে	জন্ম	বিশেষ্য	
জন্মতে	জন্ম	বিশেষ্য	
জন্মের	জন্ম	বিশেষ্য	
জন্মাই	জন্ম	বিশেষ্য	
জমানো	জমা	বিশেষ্য	
জমাই	জমা	বিশেষ্য	
জমেছে	জমা	বিশেষ্য	
জমে	জমা	বিশেষ্য	
জমাতে	জমা	বিশেষ্য	
জমিকে	জমি	বিশেষ্য	
জমির	জমি	বিশেষ্য	
জমিতে	জমি	বিশেষ্য	
জমিটা	জমি	বিশেষ্য	
জমিনে	জমি	বিশেষ্য	
জমিনের	জমি	বিশেষ্য	
জমিদার	জমি	বিশেষ্য	
জমিন	জমি	বিশেষ্য	
জমিটি	জমি	বিশেষ্য	
জয়ই	জয়	ক্রিয়া	
জয়িতা	জয়	ক্রিয়া	
জয়ী	জয়	ক্রিয়া	
জয়ি	জয়	ক্রিয়া	
জয়কে	জয়	ক্রিয়া	
জয়ের	জয়	ক্রিয়া	
জলার	জল	বিশেষ্য	
জলটা	জল	বিশেষ্য	
জলকে	জল	বিশেষ্য	
জলের	জল	বিশেষ্য	
জলে	জল	বিশেষ্য	
জাহাজকে	জাহাজ	বিশেষ্য	
জাহাজের	জাহাজ	বিশেষ্য	
জাহাজে	জাহাজ	বিশেষ্য	
জাহাজটি	জাহাজ	বিশেষ্য	
জাহাজটা	জাহাজ	বিশেষ্য	
জাহাজটির	জাহাজ	বিশেষ্য	
জাহাজই	জাহাজ	বিশেষ্য	
জাহাজটিতে	জাহাজ	বিশেষ্য	
জাহাজেই	জাহাজ	বিশেষ্য	
জাহাজেরই	জাহাজ	বিশেষ্য	
জানানো	জানা	ক্রিয়া	
জানাতে	জানা	ক্রিয়া	
জানিয়ে	জানা	ক্রিয়া	
জানিয়েছেন	জানা	ক্রিয়া	
জানাচ্ছি	জানা	ক্রিয়া	
জানিয়েছিলাম	জানা	ক্রিয়া	
জানাব	জানা	ক্রিয়া	
জানতেন	জানা	ক্রিয়া	
জানিয়েছে	জানা	ক্রিয়া	
জানিয়েছি	জানা	ক্রিয়া	
জাতির	জাতি	বিশেষ্য	
জাতিটা	জাতি	বিশেষ্য	
জাতিতে	জাতি	বিশেষ্য	
জাতিকে	জাতি	বিশেষ্য	
জাতিই	জাতি	বিশেষ্য	
জাতেরই	জাত	বিশেষ্য	
জাতের	জাত	বিশেষ্য	
জীবনে	জীবন	বিশেষ্য	
জীবনকে	জীবন	বিশেষ্য	
জীবনের	জীবন	বিশেষ্য	
জীবনই	জীবন	বিশেষ্য	
জীবনটা	জীবন	বিশেষ্য	
জীবনটাকে	জীবন	বিশেষ্য	
জীবনটায়	জীবন	বিশেষ্য	
জিনে	জিন	বিশেষ্য	
জিনের	জিন	বিশেষ্য	
জিনকে	জিন	বিশেষ্য	
জিনই	জিন	বিশেষ্য	
জিনদের	জিন	বিশেষ্য	
জিনিসটা	জিনিস	বিশেষ্য	
জিনিসে	জিনিস	বিশেষ্য	
জিনিসের	জিনিস	বিশেষ্য	
জিনিসেই	জিনিস	বিশেষ্য	
জিনিসকে	জিনিস	বিশেষ্য	
জিজ্ঞেসা	জিজ্ঞেস	বিশেষ্য	জিজ্ঞেসা
জিজ্ঞাসা	জিজ্ঞেস	বিশেষ্য	জিজ্ঞাসা
জিজ্ঞেসই	জিজ্ঞেস	বিশেষ্য	
জিজ্ঞাসের	জিজ্ঞেস	বিশেষ্য	জিজ্ঞাস
জগের	জগ	বিশেষ্য	
জগটা	জগ	বিশেষ্য	
জগটি	জগ	বিশেষ্য	
জগই	জগ	বিশেষ্য	
জগতে	জগত	বিশেষ্য	
জগতের	জগত	বিশেষ্য	
জগতটা	জগত	বিশেষ্য	
জগতেই	জগত	বিশেষ্য	
জগতকে	জগত	বিশেষ্য	
জামের	জাম	বিশেষ্য	
জামে	জাম	বিশেষ্য	
জামটি	জাম	বিশেষ্য	
জামটিকে	জাম	বিশেষ্য	
জামটা	জাম	বিশেষ্য	
জামটাকে	জাম	বিশেষ্য	
জোকটা	জোক	বিশেষ্য	
জোকটি	জোক	বিশেষ্য	
জোককে	জোক	বিশেষ্য	
জোককের	জোক	বিশেষ্য	
জোকই	জোক	বিশেষ্য	
জটে	জট	বিশেষ্য	
জটের	জট	বিশেষ্য	
জটটা	জট	বিশেষ্য	
জটি	জট	বিশেষ্য	
জালে	জাল	বিশেষ্য	
জালের	জাল	বিশেষ্য	
জালটা	জাল	বিশেষ্য	
জালটি	জাল	বিশেষ্য	
জালই	জাল	বিশেষ্য	
জালটায়	জাল	বিশেষ্য	
জুতায়	জুতা	বিশেষ্য	
জুতার	জুতা	বিশেষ্য	
জুতাতে	জুতা	বিশেষ্য	
জুতাটা	জুতা	বিশেষ্য	
জুতাটি	জুতা	বিশেষ্য	
জন্তুটি	জন্তু	বিশেষ্য	
জন্তুতে	জন্তু	বিশেষ্য	
জন্তুর	জন্তু	বিশেষ্য	
জন্তুকে	জন্তু	বিশেষ্য	
জন্তুই	জন্তু	বিশেষ্য	
জনককে	জনক	বিশেষ্য	
জনককের	জনক	বিশেষ্য	
জনকই	জনক	বিশেষ্য	
জনপদে	জনপদ	বিশেষ্য	
জনপদের	জনপদ	বিশেষ্য	
জনপদটি	জনপদ	বিশেষ্য	
জনপদটা	জনপদ	বিশেষ্য	
জনমে	জনম	বিশেষ্য	
জনমের	জনম	বিশেষ্য	
জনমই	জনম	বিশেষ্য	
জনতার	জনতা	বিশেষ্য	
জনতাকে	জনতা	বিশেষ্য	
জনতাদের	জনতা	বিশেষ্য	
জনতারা	জনতা	বিশেষ্য	
জতুকের	জতুক	বিশেষ্য	
জতুকে	জতুক	বিশেষ্য	
জতুকই	জতুক	বিশেষ্য	
জবার	জবা	বিশেষ্য	
জবাটি	জবা	বিশেষ্য	
জবাতে	জবা	বিশেষ্য	
জবাটা	জবা	বিশেষ্য	
জবানে	জবান	বিশেষ্য	
জবানের	জবান	বিশেষ্য	
জবানটা	জবান	বিশেষ্য	
জবাবে	জবাব	বিশেষ্য	
জবাবের	জবাব	বিশেষ্য	
জমিনে	জমিন	বিশেষ্য	
জমিনটা	জমিন	বিশেষ্য	
জমিনই	জমিন	বিশেষ্য	
জমিনটায়	জমিন	বিশেষ্য	
জমিনটার	জমিন	বিশেষ্য	
জরায়ুতে	জরায়ু	বিশেষ্য	
জরায়ুকে	জরায়ু	বিশেষ্য	
জরায়ুই	জরায়ু	বিশেষ্য	
জরায়ুর	জরায়ু	বিশেষ্য	
জরিপে	জরিপ	বিশেষ্য	
জরিপের	জরিপ	বিশেষ্য	
জরিপটা	জরিপ	বিশেষ্য	
জরিপই	জরিপ	বিশেষ্য	
জলপাইটা	জলপাই	বিশেষ্য	
জলপাইটি	জলপাই	বিশেষ্য	
জলপাইয়ে	জলপাই	বিশেষ্য	
জলপাইতে	জলপাই	বিশেষ্য	
জলপাইকে	জলপাই	বিশেষ্য	
জলপাইটার	জলপাই	বিশেষ্য	
জলসার	জলসা	বিশেষ্য	
জলসাতে	জলসা	বিশেষ্য	
জলাশয়ে	জলাশয়	বিশেষ্য	
জলাশয়ের	জলাশয়	বিশেষ্য	
জলাশয়ই	জলাশয়	বিশেষ্য	
জাজিমে	জাজিম	বিশেষ্য	
জাজিমটা	জাজিম	বিশেষ্য	
জাজিমটি	জাজিম	বিশেষ্য	
জাজিমই	জাজিম	বিশেষ্য	
জাজিমের	জাজিম	বিশেষ্য	
জাজিমকে	জাজিম	বিশেষ্য	
জানাজায়	জানাজা	বিশেষ্য	
জানাজাতে	জানাজা	বিশেষ্য	
জানাজার	জানাজা	বিশেষ্য	
জামানতে	জামানত	বিশেষ্য	
জামানতের	জামানত	বিশেষ্য	
জামানতটা	জামানত	বিশেষ্য	
জামাতে	জামা	বিশেষ্য	
জামার	জামা	বিশেষ্য	
জামাটি	জামা	বিশেষ্য	
জামাটা	জামা	বিশেষ্য	
জামায়	জামা	বিশেষ্য	
জামাটার	জামা	বিশেষ্য	
জায়গার	জায়গা	বিশেষ্য	
জায়গাতে	জায়গা	বিশেষ্য	
জায়গায়	জায়গা	বিশেষ্য	
জায়গাটা	জায়গা	বিশেষ্য	
জায়গাটি	জায়গা	বিশেষ্য	
জায়গাই	জায়গা	বিশেষ্য	
জামরুলটি	জামরুল	বিশেষ্য	
জামরুলে	জামরুল	বিশেষ্য	
জামরুলকে	জামরুল	বিশেষ্য	
জামরুলটা	জামরুল	বিশেষ্য	
জামরুলই	জামরুল	বিশেষ্য	
জারুলটা	জারুল	বিশেষ্য	
জারুলটি	জারুল	বিশেষ্য	
জারুলকে	জারুল	বিশেষ্য	
জারুলই	জারুল	বিশেষ্য	
জারুলে	জারুল	বিশেষ্য	
জালিমের	জালিম	বিশেষ্য	
জালিমটা	জালিম	বিশেষ্য	
জাহানে	জাহান	বিশেষ্য	
জাহানের	জাহান	বিশেষ্য	
জাহানই	জাহান	বিশেষ্য	
জাহিলটা	জাহিল	বিশেষ্য	
জাহিলটাকে	জাহিল	বিশেষ্য	
জালির	জালি	বিশেষ্য	
জালিতে	জালি	বিশেষ্য	
জালিটা	জালি	বিশেষ্য	
জালিটি	জালি	বিশেষ্য	
জালিই	জালি	বিশেষ্য	
জালিটায়	জালি	বিশেষ্য	
জিব্বার	জিব্বা	বিশেষ্য	
জিব্বাতে	জিব্বা	বিশেষ্য	
জিব্বাটা	জিব্বা	বিশেষ্য	
জিব্বাকে	জিব্বা	বিশেষ্য	
জিব্বায়	জিব্বা	বিশেষ্য	
জিবিকার	জিবিকা	বিশেষ্য	
জিবিকাতে	জিবিকা	বিশেষ্য	
জিবিকায়	জিবিকা	বিশেষ্য	
জিদে	জিদ	বিশেষ্য	
জিদই	জিদ	বিশেষ্য	
জিরাফে	জিরাফ	বিশেষ্য	
জিরাফের	জিরাফ	বিশেষ্য	
জিরাফটা	জিরাফ	বিশেষ্য	
জিরাফটি	জিরাফ	বিশেষ্য	
জিরাফদের	জিরাফ	বিশেষ্য	
জিরাফরা	জিরাফ	বিশেষ্য	
জিহাদে	জিহাদ	বিশেষ্য	
জিহাদের	জিহাদ	বিশেষ্য	
জিহাদকে	জিহাদ	বিশেষ্য	
জিহাদই	জিহাদ	বিশেষ্য	
জিলাপিটি	জিলাপি	বিশেষ্য	
জিলাপিটা	জিলাপি	বিশেষ্য	
জিলাপিই	জিলাপি	বিশেষ্য	
জিলাপির	জিলাপি	বিশেষ্য	
জিলাপিতে	জিলাপি	বিশেষ্য	
জিলাপিটির	জিলাপি	বিশেষ্য	
জীবে	জীব	বিশেষ্য	
জীবের	জীব	বিশেষ্য	
জীবটা	জীব	বিশেষ্য	
জীবরি	জীব	বিশেষ্য	
জীবাণুর	জীবাণু	বিশেষ্য	
জীবাণুতে	জীবাণু	বিশেষ্য	
জীবাণুকে	জীবাণু	বিশেষ্য	
জীবাণুটা	জীবাণু	বিশেষ্য	
জীবাণুটি	জীবাণু	বিশেষ্য	
জুইতে	জুই	বিশেষ্য	
জুটির	জুটি	বিশেষ্য	
জুটিতে	জুটি	বিশেষ্য	
জুটিটা	জুটি	বিশেষ্য	
জুয়ায়	জুয়া	বিশেষ্য	
জুয়ার	জুয়া	বিশেষ্য	
জুয়াতে	জুয়া	বিশেষ্য	
জুয়াটা	জুয়া	বিশেষ্য	
জুলুমে	জুলুম	বিশেষ্য	
জুলুমের	জুলুম	বিশেষ্য	
জুলুমটা	জুলুম	বিশেষ্য	
জুলুমই	জুলুম	বিশেষ্য	
জেলার	জেলা	বিশেষ্য	
জেলাতে	জেলা	বিশেষ্য	
জেলাটা	জেলা	বিশেষ্য	
জেলাই	জেলা	বিশেষ্য	
জেলাটি	জেলা	বিশেষ্য	
জেলের	জেলে	বিশেষ্য	
জেলেরা	জেলে	বিশেষ্য	
জেলেদের	জেলে	বিশেষ্য	
জেলেকে	জেলে	বিশেষ্য	
জেলেটা	জেলে	বিশেষ্য	
জৈবসারে	জৈবসার	বিশেষ্য	
জৈবসারটা	জৈবসার	বিশেষ্য	
জৈবসারই	জৈবসার	বিশেষ্য	
জোড়ার	জোড়া	বিশেষণ	
জোড়াতে	জোড়া	বিশেষণ	
জোড়াটা	জোড়া	বিশেষণ	
জোড়াটি	জোড়া	বিশেষণ	
জোড়াই	জোড়া	বিশেষণ	
জোয়ারে	জোয়ার	বিশেষ্য	
জোয়ারটা	জোয়ার	বিশেষ্য	
জোয়ারটি	জোয়ার	বিশেষ্য	
জোরে	জোর	বিশেষ্য	জোরে
জোরই	জোর	বিশেষ্য	
ঝরনার	ঝরনা	বিশেষ্য	
ঝরনাতে	ঝরনা	বিশেষ্য	
ঝরনাকে	ঝরনা	বিশেষ্য	
ঝরনাটা	ঝরনা	বিশেষ্য	
ঝরনাই	ঝরনা	বিশেষ্য	
ঝরনায়	ঝরনা	বিশেষ্য	
ঝলসার	ঝলসা	বিশেষ্য	
ঝলসাতে	ঝলসা	বিশেষ্য	
ঝাড়ে	ঝাড়	বিশেষ্য	
ঝাড়ের	ঝাড়	বিশেষ্য	
ঝাড়টি	ঝাড়	বিশেষ্য	
ঝাড়টা	ঝাড়	বিশেষ্য	
ঝাড়কে	ঝাড়	বিশেষ্য	
ঝাড়ই	ঝাড়	বিশেষ্য	
ঝিনুকে	ঝিনুক	বিশেষ্য	
ঝিনুকটা	ঝিনুক	বিশেষ্য	
ঝিনুকটি	ঝিনুক	বিশেষ্য	
ঝিনুকের	ঝিনুক	বিশেষ্য	
ঝিনুকই	ঝিনুক	বিশেষ্য	
ঝুমকার	ঝুমকা	বিশেষ্য	
ঝুমকাটা	ঝুমকা	বিশেষ্য	
ঝুমকাটি	ঝুমকা	বিশেষ্য	
ঝুমকাতে	ঝুমকা	বিশেষ্য	
ঝুলির	ঝুলি	বিশেষ্য	
ঝুলিতে	ঝুলি	বিশেষ্য	
ঝুলিটা	ঝুলি	বিশেষ্য	
ঝুলিটি	ঝুলি	বিশেষ্য	
ঝুলিই	ঝুলি	বিশেষ্য	
ঝড়টা	ঝড়	বিশেষ্য	
ঝড়কে	ঝড়	বিশেষ্য	
ঝড়টি	ঝড়	বিশেষ্য	
ঝড়ের	ঝড়	বিশেষ্য	
ঝড়ে	ঝড়	বিশেষ্য	
ঝুলানো	ঝুলা	বিশেষ্য	
ঝোলাতে	ঝুলা	বিশেষ্য	
ঝুলাই	ঝুলা	বিশেষ্য	
ঝুলছে	ঝুলা	বিশেষ্য	
ঝুলাইত	ঝুলা	বিশেষ্য	
ঝুলিয়েছে	ঝুলা	বিশেষ্য	
ঝুলতে	ঝুলা	বিশেষ্য	
ঝোপটাতে	ঝোপ	বিশেষ্য	
ঝোপই	ঝোপ	বিশেষ্য	
ঝোপটা	ঝোপ	বিশেষ্য	
ঝোপের	ঝোপ	বিশেষ্য	
ঝোপে	ঝোপ	বিশেষ্য	
টাকায়	টাকা	বিশেষ্য	
টাকার	টাকা	বিশেষ্য	
টাকাকে	টাকা	বিশেষ্য	
টাকাটা	টাকা	বিশেষ্য	
টাকাই	টাকা	বিশেষ্য	
টিপুনি	টিপ	বিশেষ্য	
টিপুকে	টিপ	বিশেষ্য	
টিপই	টিপ	বিশেষ্য	
টিপে	টিপ	বিশেষ্য	
টিপের	টিপ	বিশেষ্য	
টবে	টব	বিশেষ্য	
টবও	টব	বিশেষ্য	
টবের	টব	বিশেষ্য	
টবটা	টব	বিশেষ্য	
টবটি	টব	বিশেষ্য	
টবকে	টব	বিশেষ্য	
টবটাকে	টব	বিশেষ্য	
টকের	টক	বিশেষ্য	
টকটা	টক	বিশেষ্য	
টকই	টক	বিশেষ্য	
টলমলে	টলমল	বিশেষ্য	
টলমলানো	টলমল	বিশেষ্য	
টলমলই	টলমল	বিশেষ্য	
টলমলের	টলমল	বিশেষ্য	
টলমলানি	টলমল	বিশেষ্য	
টোকাই	টোকা	বিশেষ্য	
টোকায়	টোকা	বিশেষ্য	
টোকান	টোকা	বিশেষ্য	
টোকাতে	টোকা	বিশেষ্য	
টাকির	টাকি	বিশেষ্য	
টাকিতে	টাকি	বিশেষ্য	
টাকিটা	টাকি	বিশেষ্য	
টাকিই	টাকি	বিশেষ্য	
টার্গেটটা	টার্গেট	বিশেষ্য	
টার্গেটকে	টার্গেট	বিশেষ্য	
টার্গেটই	টার্গেট	বিশেষ্য	
টার্গেটর	টার্গেট	বিশেষ্য	
টগরে	টগর	বিশেষ্য	
টগরটা	টগর	বিশেষ্য	
টগরকে	টগর	বিশেষ্য	
টগরটি	টগর	বিশেষ্য	
টগরই	টগর	বিশেষ্য	
টনে	টন	বিশেষ্য	
টনের	টন	বিশেষ্য	
টনই	টন	বিশেষ্য	
টনকে	টন	বিশেষ্য	
টমেটোর	টমেটো	বিশেষ্য	
টমেটোতে	টমেটো	বিশেষ্য	
টমেটোটা	টমেটো	বিশেষ্য	
টমেটোই	টমেটো	বিশেষ্য	
টমেটোটি	টমেটো	বিশেষ্য	
টফিটা	টফি	বিশেষ্য	
টফির	টফি	বিশেষ্য	
টফিতে	টফি	বিশেষ্য	
টয়লেটে	টয়লেট	বিশেষ্য	
টয়লেটের	টয়লেট	বিশেষ্য	
টয়লেটটি	টয়লেট	বিশেষ্য	
টয়লেটটা	টয়লেট	বিশেষ্য	
টয়লেটই	টয়লেট	বিশেষ্য	
টেবিলে	টেবিল	বিশেষ্য	
টেবিলের	টেবিল	বিশেষ্য	
টেবিলটা	টেবিল	বিশেষ্য	
টেবিলটি	টেবিল	বিশেষ্য	
টেবিলই	টেবিল	বিশেষ্য	
টহলে	টহল	বিশেষ্য	
টহলের	টহল	বিশেষ্য	
টহলকে	টহল	বিশেষ্য	
টাইফুনকে	টাইফুন	বিশেষ্য	
টাইফুনটা	টাইফুন	বিশেষ্য	
টাইফুনে	টাইফুন	বিশেষ্য	
টাইফুনের	টাইফুন	বিশেষ্য	
টাইফুনই	টাইফুন	বিশেষ্য	
টিউমারে	টিউমার	বিশেষ্য	
টিউমারের	টিউমার	বিশেষ্য	
টিউমারটা	টিউমার	বিশেষ্য	
টিউমারটি	টিউমার	বিশেষ্য	
টিউমারই	টিউমার	বিশেষ্য	
টউশনির	টউশনি	বিশেষ্য	
টউশনিতে	টউশনি	বিশেষ্য	
টউশনিকে	টউশনি	বিশেষ্য	
টউশনিটা	টউশনি	বিশেষ্য	
টউশনিটার	টউশনি	বিশেষ্য	
টিকটিকির	টিকটিকি	বিশেষ্য	
টিকটিকিটা	টিকটিকি	বিশেষ্য	
টিকটিকিকে	টিকটিকি	বিশেষ্য	
টিকটিকিদের	টিকটিকি	বিশেষ্য	
টিকটিকিই	টিকটিকি	বিশেষ্য	
টিকাদারের	টিকাদার	বিশেষ্য	
টিকাদারদের	টিকাদার	বিশেষ্য	
টিকাদারকে	টিকাদার	বিশেষ্য	
টিকাদারটা	টিকাদার	বিশেষ্য	
টিকাদারই	টিকাদার	বিশেষ্য	
টিকলির	টিকলি	বিশেষ্য	
টিকলিতে	টিকলি	বিশেষ্য	
টিকলিটা	টিকলি	বিশেষ্য	
টিকলিই	টিকলি	বিশেষ্য	
টিকলিটার	টিকলি	বিশেষ্য	
টিকার	টিকা	বিশেষ্য	
টিকাকে	টিকা	বিশেষ্য	
টিকাতে	টিকা	বিশেষ্য	
টিকাই	টিকা	বিশেষ্য	
টিসুতে	টিসু	বিশেষ্য	
টিসুর	টিসু	বিশেষ্য	
টিসুটা	টিসু	বিশেষ্য	
টিসুটি	টিসু	বিশেষ্য	
টিসুই	টিসু	বিশেষ্য	
টিভিতে	টিভি	বিশেষ্য	
টিভির	টিভি	বিশেষ্য	
টিভিটা	টিভি	বিশেষ্য	
টিভিটি	টিভি	বিশেষ্য	
টিভিই	টিভি	বিশেষ্য	
টিভিটার	টিভি	বিশেষ্য	
টিফিনে	টিফিন	বিশেষ্য	
টিফিনের	টিফিন	বিশেষ্য	
টিফিনকে	টিফিন	বিশেষ্য	
টিফিনই	টিফিন	বিশেষ্য	
টুকরার	টুকরা	বিশেষ্য	
টুকরাতে	টুকরা	বিশেষ্য	
টুকরাটা	টুকরা	বিশেষ্য	
টুকরাটি	টুকরা	বিশেষ্য	
টুকরাকে	টুকরা	বিশেষ্য	
টুলে	টুল	বিশেষ্য	
টুলের	টুল	বিশেষ্য	
টুলটা	টুল	বিশেষ্য	
টুলই	টুল	বিশেষ্য	
টুলকে	টুল	বিশেষ্য	
টেলিভিশনে	টেলিভিশন	বিশেষ্য	
টেলিভিশনটা	টেলিভিশন	বিশেষ্য	
টেলিভিশনই	টেলিভিশন	বিশেষ্য	
টেলিভিশনটি	টেলিভিশন	বিশেষ্য	
টেলিভিশনকে	টেলিভিশন	বিশেষ্য	
টেলিফোনে	টেলিফোন	বিশেষ্য	
টেলিফোনের	টেলিফোন	বিশেষ্য	
টেলিফোনকে	টেলিফোন	বিশেষ্য	
টেলিফোনটা	টেলিফোন	বিশেষ্য	
টেলিফোনই	টেলিফোন	বিশেষ্য	
ট্রেনে	ট্রেন	বিশেষ্য	
ট্রেনকে	ট্রেন	বিশেষ্য	
ট্রেনটা	ট্রেন	বিশেষ্য	
ট্রেনটি	ট্রেন	বিশেষ্য	
ট্রেনটায়	ট্রেন	বিশেষ্য	
ট্রেনের	ট্রেন	বিশেষ্য	
ট্রায়ালে	ট্রায়াল	বিশেষ্য	
ট্রায়ালের	ট্রায়াল	বিশেষ্য	
ট্রাকে	ট্রাক	বিশেষ্য	
ট্রাকের	ট্রাক	বিশেষ্য	
ট্রাকই	ট্রাক	বিশেষ্য	
ট্রাকটা	ট্রাক	বিশেষ্য	
ট্রাকটি	ট্রাক	বিশেষ্য	
ট্রলারে	ট্রলার	বিশেষ্য	
ট্রলারটা	ট্রলার	বিশেষ্য	
ট্রলারটি	ট্রলার	বিশেষ্য	
ট্রলারকে	ট্রলার	বিশেষ্য	
ট্রলারই	ট্রলার	বিশেষ্য	
ঠকুমার	ঠকুমা	বিশেষ্য	
ঠকুমাকে	ঠকুমা	বিশেষ্য	
ঠাকুরকে	ঠাকুর	বিশেষ্য	
ঠাকুরদের	ঠাকুর	বিশেষ্য	
ঠাকুররা	ঠাকুর	বিশেষ্য	
ঠিকানাটা	ঠিকানা	বিশেষ্য	
ঠিকানাটি	ঠিকানা	বিশেষ্য	
ঠিকানাকে	ঠিকানা	বিশেষ্য	
ঠিকানার	ঠিকানা	বিশেষ্য	
ঠিকানায়	ঠিকানা	বিশেষ্য	
ঠিকাদাররা	ঠিকাদার	বিশেষ্য	
ঠিকাদারদের	ঠিকাদার	বিশেষ্য	
ঠিকাদারকে	ঠিকাদার	বিশেষ্য	
ঠিকাদারই	ঠিকাদার	বিশেষ্য	
ঠোঁটে	ঠোঁট	বিশেষ্য	
ঠোঁটের	ঠোঁট	বিশেষ্য	
ঠোঁটটা	ঠোঁট	বিশেষ্য	
ঠোঁটই	ঠোঁট	বিশেষ্য	
ঠোঁটকে	ঠোঁট	বিশেষ্য	
ঠিকার	ঠিকা	বিশেষ্য	
ঠিকাটা	ঠিকা	বিশেষ্য	
ঠিকাটি	ঠিকা	বিশেষ্য	
ঠিকাতে	ঠিকা	বিশেষ্য	
ঠিকাই	ঠিকা	বিশেষ্য	
ঠোঙার	ঠোঙা	বিশেষ্য	
ঠোঙাতে	ঠোঙা	বিশেষ্য	
ঠোঙাটা	ঠোঙা	বিশেষ্য	
ঠোঙাটি	ঠোঙা	বিশেষ্য	
ডজনে	ডজন	বিশেষ্য	
ডজনের	ডজন	বিশেষ্য	
ডজনই	ডজন	বিশেষ্য	
ডাবলে	ডাবল	বিশেষ্য	
ডাবলই	ডাবল	বিশেষ্য	
ডলফিনে	ডলফিন	বিশেষ্য	
ডলফিনের	ডলফিন	বিশেষ্য	
ডলফিনটা	ডলফিন	বিশেষ্য	
ডলফিনটি	ডলফিন	বিশেষ্য	
ডলফিনকে	ডলফিন	বিশেষ্য	
ডলার	ডলা	বিশেষ্য	
ডলাতে	ডলা	বিশেষ্য	
ডাইনোসরে	ডাইনোসর	বিশেষ্য	
ডাইনোসরকে	ডাইনোসর	বিশেষ্য	
ডাইনোসরদের	ডাইনোসর	বিশেষ্য	
ডাইনোসররা	ডাইনোসর	বিশেষ্য	
ডাইনোসরই	ডাইনোসর	বিশেষ্য	
ডাককে	ডাক	বিশেষ্য	
ডাকের	ডাক	বিশেষ্য	
ডাকটি	ডাক	বিশেষ্য	
ডাকটা	ডাক	বিশেষ্য	
ডাকই	ডাক	বিশেষ্য	
ডাহুকদের	ডাহুক	বিশেষ্য	
ডাহুকরা	ডাহুক	বিশেষ্য	
ডাহুককে	ডাহুক	বিশেষ্য	
ডাহুকটা	ডাহুক	বিশেষ্য	
ডাহুকই	ডাহুক	বিশেষ্য	
ডাক্তাররা	ডাক্তার	বিশেষ্য	
ডাক্তারদের	ডাক্তার	বিশেষ্য	
ডাক্তারকে	ডাক্তার	বিশেষ্য	
ডানার	ডানা	বিশেষ্য	
ডানায়	ডানা	বিশেষ্য	
ডানাতে	ডানা	বিশেষ্য	
ডানাটি	ডানা	বিশেষ্য	
ডায়রির	ডায়রি	বিশেষ্য	
ডায়রিতে	ডায়রি	বিশেষ্য	
ডায়রিটা	ডায়রি	বিশেষ্য	
ডায়রিই	ডায়রি	বিশেষ্য	
ডায়রিটি	ডায়রি	বিশেষ্য	
ডায়রিয়াতে	ডায়রিয়া	বিশেষ্য	
ডায়রিয়াকে	ডায়রিয়া	বিশেষ্য	
ডায়রিয়ার	ডায়রিয়া	বিশেষ্য	
ডায়রিয়ায়	ডায়রিয়া	বিশেষ্য	
ডায়রিয়াই	ডায়রিয়া	বিশেষ্য	
ডায়বেটিসই	ডায়বেটিস	বিশেষ্য	
ডায়বেটিসে	ডায়বেটিস	বিশেষ্য	
ডায়বেটিসকে	ডায়বেটিস	বিশেষ্য	
ডায়বেটিসের	ডায়বেটিস	বিশেষ্য	
ডায়মন্ডকে	ডায়মন্ড	বিশেষ্য	
ডায়মন্ডে	ডায়মন্ড	বিশেষ্য	
ডায়মন্ডই	ডায়মন্ড	বিশেষ্য	
ডায়মন্ডটি	ডায়মন্ড	বিশেষ্য	
জন্ডিসে	জন্ডিস	বিশেষ্য	
জন্ডিসের	জন্ডিস	বিশেষ্য	
জন্ডিসকে	জন্ডিস	বিশেষ্য	
জন্ডিসটি	জন্ডিস	বিশেষ্য	
জন্ডিসই	জন্ডিস	বিশেষ্য	
ডালিয়ার	ডালিয়া	বিশেষ্য	
ডালিয়াটি	ডালিয়া	বিশেষ্য	
ডালিয়াকে	ডালিয়া	বিশেষ্য	
ডালিয়াই	ডালিয়া	বিশেষ্য	
ডালিয়ায়	ডালিয়া	বিশেষ্য	
ডিঙার	ডিঙা	বিশেষ্য	
ডিঙাতে	ডিঙা	বিশেষ্য	
ডিঙাটি	ডিঙা	বিশেষ্য	
ডিঙাই	ডিঙা	বিশেষ্য	
ডিজেলের	ডিজেল	বিশেষ্য	
ডিজেলই	ডিজেল	বিশেষ্য	
ডিমে	ডিম	বিশেষ্য	
ডিমকে	ডিম	বিশেষ্য	
ডিমটা	ডিম	বিশেষ্য	
ডিমটি	ডিম	বিশেষ্য	
ডিমই	ডিম	বিশেষ্য	
ডুবুরির	ডুবুরি	বিশেষ্য	
ডুবুরিদের	ডুবুরি	বিশেষ্য	
ডুবুরিকে	ডুবুরি	বিশেষ্য	
ডুবুরিরা	ডুবুরি	বিশেষ্য	
ডুবুরিই	ডুবুরি	বিশেষ্য	
ডাবে	ডাব	বিশেষ্য	
ডাবের	ডাব	বিশেষ্য	
ডাবটি	ডাব	বিশেষ্য	
ডাবটা	ডাব	বিশেষ্য	
ডাকার	ডাকা	ক্রিয়া	
ডাকাই	ডাকা	ক্রিয়া	
ডাকতে	ডাকা	ক্রিয়া	
ডাকতেন	ডাকা	ক্রিয়া	
ডাক	ডাকা	ক্রিয়া	
ডালে	ডাল	বিশেষ্য	
ডালের	ডাল	বিশেষ্য	
ডালই	ডাল	বিশেষ্য	
ডালটি	ডাল	বিশেষ্য	
ডালটিতে	ডাল	বিশেষ্য	
ঢাকে	ঢাক	বিশেষ্য	
ঢাকের	ঢাক	বিশেষ্য	
ঢাকটা	ঢাক	বিশেষ্য	
ঢাকটি	ঢাক	বিশেষ্য	
ঢালুতে	ঢালু	বিশেষ্য	
ঢালুর	ঢালু	বিশেষ্য	
ঢালাইকে	ঢালাই	বিশেষ্য	
ঢালাইটা	ঢালাই	বিশেষ্য	
ঢালাইতে	ঢালাই	বিশেষ্য	
ঢেউটা	ঢেউ	বিশেষ্য	
ঢেউই	ঢেউ	বিশেষ্য	
ঢেউকে	ঢেউ	বিশেষ্য	